DATE,PLATFORM,EVENT_NAME,DESTINATION_CHAIN_NAME,NUMBER_OF_RECEIVER_USER,NUMBER_OF_SENDER_USER,NUMBER_OF_TRANSACTION,TOTAL_NUMBER_OF_USERS
2024-03-18 00:00:00.000,layerzero,ReceiveEvent,Aptos,67796,11,92893,67807
2024-03-11 00:00:00.000,layerzero,ReceiveEvent,Aptos,65391,11,90208,65402
2024-03-25 00:00:00.000,layerzero,ReceiveEvent,Aptos,64756,12,85437,64768
2024-04-08 00:00:00.000,layerzero,ReceiveEvent,Aptos,50147,10,67187,50157
2024-04-22 00:00:00.000,layerzero,ReceiveEvent,Aptos,45585,11,63198,45596
2024-04-01 00:00:00.000,layerzero,ReceiveEvent,Aptos,45820,11,60699,45831
2024-04-15 00:00:00.000,layerzero,ReceiveEvent,Aptos,38055,12,53063,38067
2024-03-04 00:00:00.000,layerzero,ReceiveEvent,Aptos,24111,10,35510,24121
2024-04-29 00:00:00.000,layerzero,ReceiveEvent,Aptos,26513,14,33919,26527
2024-03-11 00:00:00.000,layerzero,SendEvent,BSC,18566,18572,23507,37138
2024-03-11 00:00:00.000,layerzero,SendEvent,Polygon,17488,17467,22783,34955
2024-03-25 00:00:00.000,layerzero,SendEvent,Arbitrum,17197,17178,22611,34375
2024-03-18 00:00:00.000,layerzero,SendEvent,BSC,17775,17728,22305,35503
2024-03-18 00:00:00.000,layerzero,SendEvent,Polygon,15189,15201,21967,30390
2024-03-18 00:00:00.000,layerzero,SendEvent,Arbitrum,14889,14887,20144,29776
2024-03-25 00:00:00.000,layerzero,SendEvent,BSC,15916,15896,19998,31812
2024-03-25 00:00:00.000,layerzero,SendEvent,Polygon,13018,13016,19315,26034
2024-04-08 00:00:00.000,layerzero,SendEvent,Polygon,10894,10898,19247,21792
2024-01-15 00:00:00.000,layerzero,ReceiveEvent,Aptos,12213,11,18708,12224
2024-04-01 00:00:00.000,layerzero,SendEvent,Polygon,10071,10070,18530,20141
2024-03-18 00:00:00.000,layerzero,SendEvent,Avalanche,12965,12958,18037,25923
2024-03-25 00:00:00.000,layerzero,SendEvent,Avalanche,12976,12961,17958,25937
2024-04-08 00:00:00.000,layerzero,SendEvent,BSC,12891,12891,16952,25782
2024-04-01 00:00:00.000,layerzero,SendEvent,Arbitrum,11798,11724,16562,23522
2024-04-22 00:00:00.000,layerzero,SendEvent,Arbitrum,12152,12176,16247,24328
2024-04-08 00:00:00.000,layerzero,SendEvent,Avalanche,10507,10496,15348,21003
2024-01-08 00:00:00.000,layerzero,ReceiveEvent,Aptos,12059,11,15121,12070
2024-03-11 00:00:00.000,layerzero,SendEvent,Avalanche,12190,12134,15085,24324
2024-04-01 00:00:00.000,layerzero,SendEvent,BSC,11830,11843,14875,23673
2024-04-08 00:00:00.000,layerzero,SendEvent,Arbitrum,11038,11015,14688,22053
2024-01-29 00:00:00.000,wormhole,DepositEvent,aptos,9081,0,14650,9081
2024-02-19 00:00:00.000,layerzero,ReceiveEvent,Aptos,10586,9,14427,10595
2024-04-15 00:00:00.000,layerzero,SendEvent,Arbitrum,11213,11219,14055,22432
2024-02-12 00:00:00.000,layerzero,ReceiveEvent,Aptos,9209,11,13095,9220
2024-02-26 00:00:00.000,layerzero,ReceiveEvent,Aptos,9941,10,12946,9951
2024-04-22 00:00:00.000,layerzero,SendEvent,BSC,10011,10003,12794,20014
2024-04-01 00:00:00.000,layerzero,SendEvent,Avalanche,8580,8593,12494,17173
2024-01-22 00:00:00.000,wormhole,DepositEvent,aptos,8099,0,12384,8099
2024-02-05 00:00:00.000,layerzero,ReceiveEvent,Aptos,8771,13,12249,8784
2024-01-29 00:00:00.000,layerzero,ReceiveEvent,Aptos,9222,10,12159,9232
2024-01-22 00:00:00.000,layerzero,ReceiveEvent,Aptos,9158,10,11890,9168
2024-04-15 00:00:00.000,layerzero,SendEvent,BSC,9351,9324,11882,18675
2024-01-15 00:00:00.000,wormhole,DepositEvent,aptos,7055,0,11743,7055
2024-01-08 00:00:00.000,wormhole,DepositEvent,aptos,6983,0,11488,6983
2024-04-22 00:00:00.000,layerzero,SendEvent,Avalanche,8648,8643,11161,17291
2024-06-03 00:00:00.000,layerzero,ReceiveEvent,Aptos,9482,11,10840,9493
2024-04-22 00:00:00.000,layerzero,SendEvent,Optimism,8020,8019,10799,16039
2024-03-11 00:00:00.000,layerzero,SendEvent,Arbitrum,8382,8383,10238,16765
2024-03-04 00:00:00.000,layerzero,SendEvent,Polygon,6547,6588,9143,13135
2024-04-22 00:00:00.000,layerzero,SendEvent,Polygon,7310,7282,8929,14592
2024-06-10 00:00:00.000,layerzero,ReceiveEvent,Aptos,7443,9,8892,7452
2024-04-08 00:00:00.000,layerzero,SendEvent,Optimism,6463,6460,8868,12923
2024-04-15 00:00:00.000,layerzero,SendEvent,Avalanche,6279,6270,8838,12549
2024-05-06 00:00:00.000,layerzero,ReceiveEvent,Aptos,6760,12,8820,6772
2024-04-15 00:00:00.000,layerzero,SendEvent,Optimism,6384,6377,8439,12761
2024-03-04 00:00:00.000,layerzero,SendEvent,BSC,5339,5346,8217,10685
2024-04-15 00:00:00.000,layerzero,SendEvent,Polygon,5664,5679,7960,11343
2024-02-05 00:00:00.000,wormhole,DepositEvent,aptos,5234,0,7695,5234
2024-04-29 00:00:00.000,layerzero,SendEvent,Arbitrum,5871,5867,7402,11738
2024-04-29 00:00:00.000,layerzero,SendEvent,Avalanche,5571,5568,7297,11139
2024-04-29 00:00:00.000,layerzero,SendEvent,BSC,5114,5108,7174,10222
2024-05-13 00:00:00.000,layerzero,ReceiveEvent,Aptos,5550,10,7006,5560
2024-05-20 00:00:00.000,layerzero,ReceiveEvent,Aptos,5000,9,6363,5009
2024-06-17 00:00:00.000,layerzero,ReceiveEvent,Aptos,5284,10,6321,5294
2024-04-29 00:00:00.000,layerzero,SendEvent,Optimism,4684,4674,6164,9358
2024-02-12 00:00:00.000,layerzero,SendEvent,Polygon,4445,4619,6153,9064
2024-04-29 00:00:00.000,layerzero,SendEvent,Polygon,4186,4187,5689,8373
2024-05-27 00:00:00.000,layerzero,ReceiveEvent,Aptos,4438,10,5588,4448
2024-03-04 00:00:00.000,layerzero,SendEvent,Arbitrum,4407,4434,5391,8841
2024-03-04 00:00:00.000,layerzero,SendEvent,Avalanche,3782,3814,5139,7596
2024-01-22 00:00:00.000,wormhole,WithdrawEvent,solana,4228,4187,5100,8415
2024-01-29 00:00:00.000,wormhole,WithdrawEvent,solana,4318,4274,5000,8592
2024-01-15 00:00:00.000,wormhole,WithdrawEvent,solana,3786,3725,4623,7511
2024-06-24 00:00:00.000,layerzero,ReceiveEvent,Aptos,3557,8,4388,3565
2024-01-08 00:00:00.000,wormhole,WithdrawEvent,solana,3365,3294,4060,6659
2024-02-19 00:00:00.000,layerzero,SendEvent,Polygon,2768,2759,3515,5527
2024-02-26 00:00:00.000,layerzero,SendEvent,Polygon,2767,2767,3507,5534
2024-07-01 00:00:00.000,layerzero,ReceiveEvent,Aptos,2612,10,3366,2622
2024-07-08 00:00:00.000,layerzero,ReceiveEvent,Aptos,2499,9,3120,2508
2024-01-08 00:00:00.000,layerzero,SendEvent,Polygon,2433,2433,2983,4866
2024-05-06 00:00:00.000,layerzero,SendEvent,Arbitrum,2331,2335,2889,4666
2024-01-15 00:00:00.000,layerzero,SendEvent,Polygon,2411,2406,2830,4817
2024-02-26 00:00:00.000,layerzero,SendEvent,BSC,1949,1970,2658,3919
2024-02-05 00:00:00.000,wormhole,WithdrawEvent,solana,2251,2216,2556,4467
2024-02-05 00:00:00.000,layerzero,SendEvent,Polygon,1858,1851,2490,3709
2024-07-15 00:00:00.000,layerzero,ReceiveEvent,Aptos,1733,9,2380,1742
2024-06-10 00:00:00.000,layerzero,SendEvent,Arbitrum,2135,2140,2379,4275
2024-01-29 00:00:00.000,layerzero,SendEvent,Polygon,1979,1979,2371,3958
2024-01-22 00:00:00.000,layerzero,SendEvent,Polygon,1813,1813,2353,3626
2024-02-12 00:00:00.000,layerzero,SendEvent,BSC,1590,1614,2287,3204
2024-02-19 00:00:00.000,layerzero,SendEvent,BSC,1655,1648,2251,3303
2024-02-05 00:00:00.000,layerzero,SendEvent,BSC,1531,1536,2215,3067
2024-02-12 00:00:00.000,wormhole,DepositEvent,aptos,1556,0,2214,1556
2024-05-13 00:00:00.000,layerzero,SendEvent,Arbitrum,1831,1831,2187,3662
2024-02-12 00:00:00.000,layerzero,SendEvent,Arbitrum,1623,1615,2174,3238
2024-01-29 00:00:00.000,wormhole,WithdrawEvent,sui,824,827,2076,1651
2024-01-15 00:00:00.000,layerzero,SendEvent,BSC,1668,1665,2022,3333
2024-05-27 00:00:00.000,layerzero,SendEvent,Arbitrum,1623,1626,1972,3249
2024-02-19 00:00:00.000,layerzero,SendEvent,Arbitrum,1537,1523,1943,3060
2024-07-22 00:00:00.000,layerzero,ReceiveEvent,Aptos,1340,10,1939,1350
2024-01-08 00:00:00.000,wormhole,WithdrawEvent,celo,955,949,1881,1904
2024-01-22 00:00:00.000,wormhole,WithdrawEvent,celo,1330,1332,1864,2662
2024-02-05 00:00:00.000,layerzero,SendEvent,Arbitrum,1320,1324,1845,2644
2024-05-20 00:00:00.000,layerzero,SendEvent,Arbitrum,1533,1538,1843,3071
2024-06-24 00:00:00.000,layerzero,SendEvent,Arbitrum,1698,1703,1841,3401
2024-01-15 00:00:00.000,layerzero,SendEvent,Arbitrum,1436,1443,1833,2879
2024-01-08 00:00:00.000,layerzero,SendEvent,BSC,1445,1444,1709,2889
2024-06-03 00:00:00.000,layerzero,SendEvent,Arbitrum,1449,1452,1698,2901
2024-01-29 00:00:00.000,wormhole,WithdrawEvent,bsc,1101,1065,1679,2166
2024-02-26 00:00:00.000,layerzero,SendEvent,Avalanche,1570,1565,1678,3135
2024-01-29 00:00:00.000,wormhole,WithdrawEvent,fantom,1036,1033,1658,2069
2024-01-29 00:00:00.000,layerzero,SendEvent,BSC,1287,1271,1628,2558
2024-02-26 00:00:00.000,layerzero,SendEvent,Arbitrum,1276,1270,1615,2546
2024-07-01 00:00:00.000,layerzero,SendEvent,Arbitrum,1437,1442,1588,2879
2024-05-06 00:00:00.000,layerzero,SendEvent,Optimism,1418,1418,1585,2836
2024-01-29 00:00:00.000,layerzero,SendEvent,Arbitrum,1244,1242,1584,2486
2024-06-17 00:00:00.000,layerzero,SendEvent,Arbitrum,1369,1368,1572,2737
2024-07-29 00:00:00.000,layerzero,ReceiveEvent,Aptos,980,9,1558,989
2024-01-22 00:00:00.000,layerzero,SendEvent,BSC,1308,1308,1524,2616
2024-02-19 00:00:00.000,wormhole,DepositEvent,aptos,1068,0,1500,1068
2024-01-08 00:00:00.000,layerzero,SendEvent,Arbitrum,1218,1220,1494,2438
2024-01-15 00:00:00.000,wormhole,WithdrawEvent,sui,579,576,1458,1155
2024-01-08 00:00:00.000,wormhole,WithdrawEvent,sui,561,563,1451,1124
2024-01-22 00:00:00.000,wormhole,WithdrawEvent,sui,588,590,1405,1178
2024-01-15 00:00:00.000,wormhole,WithdrawEvent,celo,654,651,1402,1305
2024-08-05 00:00:00.000,layerzero,ReceiveEvent,Aptos,893,7,1331,900
2024-02-12 00:00:00.000,layerzero,SendEvent,Avalanche,801,798,1315,1599
2024-05-06 00:00:00.000,layerzero,SendEvent,Polygon,1170,1177,1312,2347
2024-05-06 00:00:00.000,layerzero,SendEvent,BSC,1008,1010,1303,2018
2024-07-08 00:00:00.000,layerzero,SendEvent,Arbitrum,1131,1133,1286,2264
2024-08-12 00:00:00.000,layerzero,ReceiveEvent,Aptos,749,8,1248,757
2024-08-26 00:00:00.000,layerzero,ReceiveEvent,Aptos,806,8,1245,814
2024-01-22 00:00:00.000,wormhole,WithdrawEvent,bsc,832,826,1241,1658
2024-01-22 00:00:00.000,layerzero,SendEvent,Arbitrum,959,960,1217,1919
2024-07-15 00:00:00.000,layerzero,SendEvent,Arbitrum,1060,1070,1179,2130
2024-07-29 00:00:00.000,layerzero,SendEvent,Arbitrum,960,966,1154,1926
2024-08-19 00:00:00.000,layerzero,ReceiveEvent,Aptos,801,8,1147,809
2024-02-19 00:00:00.000,layerzero,SendEvent,Avalanche,856,848,1138,1704
2024-01-22 00:00:00.000,wormhole,WithdrawEvent,fantom,956,953,1130,1909
2024-09-02 00:00:00.000,layerzero,ReceiveEvent,Aptos,688,8,1115,696
2024-05-13 00:00:00.000,layerzero,SendEvent,BSC,940,940,1106,1880
2024-02-26 00:00:00.000,wormhole,DepositEvent,aptos,691,0,1099,691
2024-01-29 00:00:00.000,wormhole,WithdrawEvent,celo,564,550,1089,1114
2024-05-06 00:00:00.000,layerzero,SendEvent,Avalanche,1015,1015,1080,2030
2024-03-11 00:00:00.000,layerzero,SendEvent,Optimism,889,896,1011,1785
2024-02-05 00:00:00.000,wormhole,WithdrawEvent,bsc,715,700,1010,1415
2024-05-13 00:00:00.000,layerzero,SendEvent,Polygon,900,899,991,1799
2024-07-22 00:00:00.000,layerzero,SendEvent,Polygon,286,963,986,1249
2024-05-13 00:00:00.000,layerzero,SendEvent,Optimism,915,919,977,1834
2024-05-27 00:00:00.000,layerzero,SendEvent,Avalanche,882,874,933,1756
2024-01-15 00:00:00.000,layerzero,SendEvent,Avalanche,796,794,919,1590
2024-05-20 00:00:00.000,layerzero,SendEvent,Avalanche,863,851,908,1714
2024-07-29 00:00:00.000,layerzero,SendEvent,Polygon,346,846,879,1192
2024-01-08 00:00:00.000,wormhole,WithdrawEvent,wormchain,1,426,876,427
2024-02-05 00:00:00.000,wormhole,WithdrawEvent,celo,482,470,870,952
2024-06-17 00:00:00.000,layerzero,SendEvent,Optimism,812,813,868,1625
2024-01-29 00:00:00.000,wormhole,WithdrawEvent,wormchain,1,283,868,284
2024-04-01 00:00:00.000,layerzero,SendEvent,Base,144,146,859,290
2024-05-27 00:00:00.000,layerzero,SendEvent,BSC,636,637,839,1273
2024-02-05 00:00:00.000,layerzero,SendEvent,Avalanche,664,659,837,1323
2024-01-15 00:00:00.000,wormhole,WithdrawEvent,fantom,581,564,833,1145
2024-01-08 00:00:00.000,wormhole,WithdrawEvent,bsc,609,606,831,1215
2024-03-11 00:00:00.000,wormhole,DepositEvent,aptos,407,0,829,407
2024-05-20 00:00:00.000,layerzero,SendEvent,Optimism,771,770,826,1541
2024-03-25 00:00:00.000,wormhole,DepositEvent,aptos,468,0,825,468
2024-02-05 00:00:00.000,wormhole,WithdrawEvent,sui,485,490,814,975
2024-03-04 00:00:00.000,layerzero,SendEvent,Optimism,693,694,805,1387
2024-07-22 00:00:00.000,layerzero,SendEvent,Arbitrum,639,640,804,1279
2024-01-15 00:00:00.000,wormhole,WithdrawEvent,bsc,631,626,800,1257
2024-05-20 00:00:00.000,layerzero,SendEvent,Polygon,708,708,794,1416
2024-09-09 00:00:00.000,layerzero,ReceiveEvent,Aptos,561,8,793,569
2024-06-03 00:00:00.000,layerzero,SendEvent,Optimism,624,619,786,1243
2024-05-13 00:00:00.000,layerzero,SendEvent,Avalanche,752,752,784,1504
2024-05-06 00:00:00.000,wormhole,DepositEvent,aptos,596,0,778,596
2024-05-20 00:00:00.000,layerzero,SendEvent,BSC,639,635,775,1274
2024-06-10 00:00:00.000,layerzero,SendEvent,Optimism,629,635,770,1264
2024-05-13 00:00:00.000,wormhole,DepositEvent,aptos,478,0,767,478
2024-01-15 00:00:00.000,wormhole,WithdrawEvent,wormchain,1,315,762,316
2024-05-27 00:00:00.000,layerzero,SendEvent,Polygon,692,688,755,1380
2024-01-08 00:00:00.000,wormhole,WithdrawEvent,polygon,609,606,752,1215
2024-01-22 00:00:00.000,layerzero,SendEvent,Avalanche,644,643,747,1287
2024-05-27 00:00:00.000,layerzero,SendEvent,Optimism,670,669,733,1339
2024-06-03 00:00:00.000,layerzero,SendEvent,Avalanche,659,653,726,1312
2024-01-29 00:00:00.000,layerzero,SendEvent,Avalanche,620,610,724,1230
2024-06-10 00:00:00.000,layerzero,SendEvent,Avalanche,485,489,712,974
2024-01-08 00:00:00.000,layerzero,SendEvent,Avalanche,627,630,700,1257
2024-06-03 00:00:00.000,layerzero,SendEvent,Polygon,650,647,696,1297
2024-04-01 00:00:00.000,wormhole,DepositEvent,aptos,359,0,696,359
2024-02-05 00:00:00.000,wormhole,WithdrawEvent,fantom,438,438,682,876
2024-03-18 00:00:00.000,wormhole,DepositEvent,aptos,369,0,676,369
2024-06-17 00:00:00.000,layerzero,SendEvent,BSC,522,551,670,1073
2024-05-20 00:00:00.000,wormhole,DepositEvent,aptos,346,0,660,346
2024-01-29 00:00:00.000,wormhole,WithdrawEvent,polygon,511,511,652,1022
2024-06-03 00:00:00.000,layerzero,SendEvent,BSC,521,517,643,1038
2024-03-04 00:00:00.000,wormhole,DepositEvent,aptos,432,0,641,432
2024-04-22 00:00:00.000,wormhole,DepositEvent,aptos,341,0,635,341
2024-06-24 00:00:00.000,wormhole,DepositEvent,aptos,322,0,625,322
2024-01-08 00:00:00.000,wormhole,WithdrawEvent,fantom,465,463,617,928
2024-06-17 00:00:00.000,wormhole,DepositEvent,aptos,338,0,608,338
2024-04-08 00:00:00.000,wormhole,DepositEvent,aptos,320,0,603,320
2024-07-15 00:00:00.000,layerzero,SendEvent,Polygon,248,578,596,826
2024-07-15 00:00:00.000,layerzero,SendEvent,Optimism,549,550,596,1099
2024-01-15 00:00:00.000,wormhole,WithdrawEvent,polygon,380,379,555,759
2024-08-12 00:00:00.000,layerzero,SendEvent,Arbitrum,436,456,553,892
2024-06-24 00:00:00.000,layerzero,SendEvent,BSC,423,434,547,857
2024-01-22 00:00:00.000,wormhole,WithdrawEvent,polygon,435,436,547,871
2024-06-17 00:00:00.000,layerzero,SendEvent,Polygon,504,509,547,1013
2024-06-24 00:00:00.000,layerzero,SendEvent,Optimism,497,499,540,996
2024-06-17 00:00:00.000,layerzero,SendEvent,Avalanche,460,466,538,926
2024-06-10 00:00:00.000,layerzero,SendEvent,BSC,417,415,537,832
2024-07-01 00:00:00.000,wormhole,DepositEvent,aptos,264,0,534,264
2024-02-05 00:00:00.000,wormhole,WithdrawEvent,polygon,464,454,533,918
2024-07-22 00:00:00.000,layerzero,SendEvent,Optimism,470,470,528,940
2024-07-08 00:00:00.000,layerzero,SendEvent,BSC,441,455,516,896
2024-08-05 00:00:00.000,layerzero,SendEvent,Arbitrum,420,427,514,847
2024-01-22 00:00:00.000,wormhole,WithdrawEvent,wormchain,1,233,507,234
2024-04-29 00:00:00.000,wormhole,DepositEvent,aptos,286,0,501,286
2024-02-26 00:00:00.000,wormhole,WithdrawEvent,solana,322,308,495,630
2024-07-08 00:00:00.000,layerzero,SendEvent,Optimism,418,420,491,838
2024-01-22 00:00:00.000,wormhole,WithdrawEvent,moonbeam,294,301,476,595
2024-09-02 00:00:00.000,layerzero,SendEvent,Arbitrum,393,394,470,787
2024-04-15 00:00:00.000,wormhole,DepositEvent,aptos,233,0,468,233
2024-02-12 00:00:00.000,wormhole,WithdrawEvent,solana,367,356,459,723
2024-06-10 00:00:00.000,wormhole,DepositEvent,aptos,261,0,454,261
2024-06-24 00:00:00.000,layerzero,SendEvent,Avalanche,363,363,453,726
2024-07-01 00:00:00.000,layerzero,SendEvent,BSC,287,321,444,608
2024-06-10 00:00:00.000,layerzero,SendEvent,Polygon,389,387,438,776
2024-07-29 00:00:00.000,layerzero,SendEvent,Optimism,373,375,419,748
2024-01-08 00:00:00.000,wormhole,WithdrawEvent,arbitrum,360,358,415,718
2024-06-03 00:00:00.000,wormhole,DepositEvent,aptos,230,0,408,230
2024-07-01 00:00:00.000,layerzero,SendEvent,Optimism,308,306,405,614
2024-08-05 00:00:00.000,layerzero,SendEvent,BSC,298,305,400,603
2024-01-15 00:00:00.000,wormhole,WithdrawEvent,moonbeam,213,212,399,425
2024-07-29 00:00:00.000,layerzero,SendEvent,BSC,291,294,392,585
2024-08-12 00:00:00.000,layerzero,SendEvent,Optimism,159,197,389,356
2024-07-15 00:00:00.000,layerzero,SendEvent,BSC,277,278,389,555
2024-03-18 00:00:00.000,layerzero,SendEvent,CoreDAO,116,115,388,231
2024-08-05 00:00:00.000,wormhole,DepositEvent,aptos,109,0,386,109
2024-07-08 00:00:00.000,layerzero,SendEvent,Polygon,339,341,382,680
2024-06-24 00:00:00.000,layerzero,SendEvent,Polygon,352,357,379,709
2024-08-19 00:00:00.000,layerzero,SendEvent,Arbitrum,297,307,374,604
2024-07-22 00:00:00.000,wormhole,DepositEvent,aptos,120,0,363,120
2024-07-29 00:00:00.000,wormhole,DepositEvent,aptos,129,0,359,129
2024-01-22 00:00:00.000,wormhole,WithdrawEvent,avalanche,262,258,357,520
2024-05-27 00:00:00.000,wormhole,DepositEvent,aptos,196,0,354,196
2024-01-08 00:00:00.000,wormhole,WithdrawEvent,avalanche,292,267,342,559
2024-09-09 00:00:00.000,layerzero,SendEvent,BSC,208,252,337,460
2024-01-29 00:00:00.000,wormhole,WithdrawEvent,arbitrum,268,268,336,536
2024-07-01 00:00:00.000,layerzero,SendEvent,Polygon,299,298,331,597
2024-09-02 00:00:00.000,layerzero,SendEvent,Optimism,251,252,330,503
2024-04-01 00:00:00.000,layerzero,SendEvent,Ethereum,303,301,328,604
2024-07-08 00:00:00.000,wormhole,DepositEvent,aptos,167,0,325,167
2024-01-29 00:00:00.000,wormhole,WithdrawEvent,avalanche,288,258,324,546
2024-01-29 00:00:00.000,wormhole,WithdrawEvent,moonbeam,225,218,323,443
2024-08-19 00:00:00.000,layerzero,SendEvent,Optimism,246,246,323,492
2024-03-18 00:00:00.000,layerzero,SendEvent,Optimism,294,295,320,589
2024-08-26 00:00:00.000,layerzero,SendEvent,Arbitrum,258,269,316,527
2024-01-22 00:00:00.000,wormhole,WithdrawEvent,arbitrum,283,284,310,567
2024-01-08 00:00:00.000,wormhole,WithdrawEvent,moonbeam,184,185,310,369
2024-08-26 00:00:00.000,layerzero,SendEvent,Optimism,184,182,308,366
2024-08-12 00:00:00.000,wormhole,DepositEvent,aptos,149,0,308,149
2024-02-19 00:00:00.000,wormhole,WithdrawEvent,solana,283,277,307,560
2024-02-19 00:00:00.000,wormhole,WithdrawEvent,celo,240,238,294,478
2024-07-22 00:00:00.000,layerzero,SendEvent,BSC,202,207,291,409
2024-04-22 00:00:00.000,layerzero,SendEvent,Ethereum,270,268,288,538
2024-03-25 00:00:00.000,layerzero,SendEvent,Ethereum,263,264,284,527
2024-08-26 00:00:00.000,wormhole,DepositEvent,aptos,104,0,281,104
2024-07-15 00:00:00.000,wormhole,DepositEvent,aptos,140,0,280,140
2024-02-12 00:00:00.000,wormhole,WithdrawEvent,celo,203,202,276,405
2024-04-22 00:00:00.000,wormhole,WithdrawEvent,sui,208,203,274,411
2024-01-15 00:00:00.000,wormhole,WithdrawEvent,avalanche,214,187,273,401
2024-02-12 00:00:00.000,wormhole,WithdrawEvent,sui,164,165,270,329
2024-08-05 00:00:00.000,layerzero,SendEvent,Polygon,230,239,270,469
2024-03-11 00:00:00.000,wormhole,WithdrawEvent,solana,202,194,270,396
2024-09-09 00:00:00.000,layerzero,SendEvent,Arbitrum,231,230,268,461
2024-01-08 00:00:00.000,layerzero,SendEvent,Base,166,166,267,332
2024-08-05 00:00:00.000,layerzero,SendEvent,Optimism,240,243,262,483
2024-02-19 00:00:00.000,layerzero,SendEvent,Optimism,233,240,261,473
2024-04-15 00:00:00.000,wormhole,WithdrawEvent,sui,171,161,257,332
2024-03-04 00:00:00.000,wormhole,WithdrawEvent,solana,175,166,255,341
2024-01-15 00:00:00.000,wormhole,WithdrawEvent,arbitrum,232,232,254,464
2024-04-08 00:00:00.000,layerzero,SendEvent,Ethereum,216,215,253,431
2024-04-08 00:00:00.000,wormhole,WithdrawEvent,sui,138,138,245,276
2024-08-19 00:00:00.000,wormhole,DepositEvent,aptos,100,0,244,100
2024-04-29 00:00:00.000,layerzero,SendEvent,Ethereum,222,222,241,444
2024-09-02 00:00:00.000,layerzero,SendEvent,BSC,183,190,239,373
2024-02-05 00:00:00.000,wormhole,WithdrawEvent,wormchain,1,126,238,127
2024-01-29 00:00:00.000,wormhole,WithdrawEvent,optimism,207,207,237,414
2024-02-12 00:00:00.000,wormhole,WithdrawEvent,polygon,203,199,237,402
2024-02-12 00:00:00.000,wormhole,WithdrawEvent,bsc,179,178,234,357
2024-05-20 00:00:00.000,wormhole,WithdrawEvent,sui,130,130,229,260
2024-02-19 00:00:00.000,wormhole,WithdrawEvent,polygon,203,200,227,403
2024-05-13 00:00:00.000,wormhole,WithdrawEvent,sui,131,130,225,261
2024-06-24 00:00:00.000,layerzero,SendEvent,Ethereum,197,197,223,394
2024-04-15 00:00:00.000,layerzero,SendEvent,Ethereum,201,201,222,402
2024-07-01 00:00:00.000,wormhole,WithdrawEvent,solana,129,110,221,239
2024-08-12 00:00:00.000,layerzero,SendEvent,BSC,143,151,220,294
2024-01-08 00:00:00.000,wormhole,WithdrawEvent,base,185,179,218,364
2024-03-25 00:00:00.000,layerzero,SendEvent,CoreDAO,95,95,215,190
2024-08-26 00:00:00.000,layerzero,SendEvent,BSC,167,176,215,343
2024-05-13 00:00:00.000,layerzero,SendEvent,Ethereum,189,189,209,378
2024-01-29 00:00:00.000,wormhole,WithdrawEvent,base,161,161,208,322
2024-09-02 00:00:00.000,wormhole,DepositEvent,aptos,86,0,205,86
2024-07-22 00:00:00.000,layerzero,SendEvent,Ethereum,192,193,205,385
2024-02-19 00:00:00.000,wormhole,WithdrawEvent,bsc,171,172,204,343
2024-03-18 00:00:00.000,layerzero,SendEvent,Ethereum,180,186,202,366
2024-08-12 00:00:00.000,layerzero,SendEvent,Polygon,144,180,201,324
2024-05-06 00:00:00.000,layerzero,SendEvent,Ethereum,186,184,199,370
2024-04-15 00:00:00.000,layerzero,SendEvent,CoreDAO,82,82,199,164
2024-03-25 00:00:00.000,wormhole,WithdrawEvent,solana,144,136,198,280
2024-08-05 00:00:00.000,wormhole,WithdrawEvent,solana,84,66,194,150
2024-02-05 00:00:00.000,wormhole,WithdrawEvent,moonbeam,153,146,191,299
2024-04-01 00:00:00.000,wormhole,WithdrawEvent,sui,126,111,184,237
2024-03-18 00:00:00.000,wormhole,WithdrawEvent,sui,94,93,184,187
2024-01-15 00:00:00.000,wormhole,WithdrawEvent,optimism,174,174,183,348
2024-06-17 00:00:00.000,wormhole,WithdrawEvent,sui,131,134,183,265
2024-02-05 00:00:00.000,wormhole,WithdrawEvent,arbitrum,170,170,181,340
2024-07-01 00:00:00.000,layerzero,SendEvent,Avalanche,152,154,181,306
2024-08-19 00:00:00.000,layerzero,SendEvent,BSC,135,139,178,274
2024-03-11 00:00:00.000,wormhole,WithdrawEvent,sui,101,99,177,200
2024-02-26 00:00:00.000,wormhole,WithdrawEvent,sui,102,104,176,206
2024-03-18 00:00:00.000,wormhole,WithdrawEvent,solana,118,106,174,224
2024-01-22 00:00:00.000,wormhole,WithdrawEvent,optimism,144,144,166,288
2024-04-22 00:00:00.000,layerzero,SendEvent,CoreDAO,73,73,166,146
2024-05-13 00:00:00.000,wormhole,WithdrawEvent,solana,111,105,164,216
2024-08-19 00:00:00.000,layerzero,SendEvent,Ethereum,150,150,162,300
2024-01-15 00:00:00.000,wormhole,WithdrawEvent,base,138,135,159,273
2024-02-05 00:00:00.000,wormhole,WithdrawEvent,base,140,140,157,280
2024-08-26 00:00:00.000,layerzero,SendEvent,Polygon,119,141,157,260
2024-01-08 00:00:00.000,wormhole,WithdrawEvent,optimism,146,146,156,292
2024-02-05 00:00:00.000,wormhole,WithdrawEvent,avalanche,133,133,156,266
2024-07-29 00:00:00.000,layerzero,SendEvent,Ethereum,138,139,156,277
2024-05-06 00:00:00.000,wormhole,WithdrawEvent,sui,76,76,154,152
2024-02-19 00:00:00.000,wormhole,WithdrawEvent,sui,101,100,154,201
2024-02-05 00:00:00.000,layerzero,SendEvent,Optimism,137,137,153,274
2024-06-24 00:00:00.000,wormhole,WithdrawEvent,solana,103,96,152,199
2024-03-11 00:00:00.000,layerzero,SendEvent,CoreDAO,106,106,152,212
2024-01-22 00:00:00.000,wormhole,WithdrawEvent,base,124,125,152,249
2024-03-18 00:00:00.000,layerzero,SendEvent,Base,137,137,148,274
2024-08-19 00:00:00.000,layerzero,SendEvent,Polygon,107,136,148,243
2024-03-25 00:00:00.000,layerzero,SendEvent,Base,48,48,147,96
2024-09-09 00:00:00.000,wormhole,DepositEvent,aptos,61,0,147,61
2024-07-29 00:00:00.000,layerzero,SendEvent,Avalanche,104,105,147,209
2024-04-29 00:00:00.000,wormhole,WithdrawEvent,sui,80,80,146,160
2024-04-08 00:00:00.000,wormhole,WithdrawEvent,ethereum,128,131,143,259
2024-09-09 00:00:00.000,layerzero,SendEvent,Optimism,119,123,143,242
2024-02-19 00:00:00.000,wormhole,WithdrawEvent,fantom,112,112,141,224
2024-04-29 00:00:00.000,wormhole,WithdrawEvent,solana,105,102,139,207
2024-09-02 00:00:00.000,layerzero,SendEvent,Polygon,124,123,138,247
2024-05-20 00:00:00.000,layerzero,SendEvent,Ethereum,118,118,137,236
2024-07-01 00:00:00.000,layerzero,SendEvent,Ethereum,115,116,137,231
2024-06-24 00:00:00.000,wormhole,WithdrawEvent,sui,81,81,136,162
2024-08-05 00:00:00.000,layerzero,SendEvent,Avalanche,108,106,135,214
2024-09-09 00:00:00.000,layerzero,SendEvent,Avalanche,115,116,134,231
2024-02-12 00:00:00.000,wormhole,WithdrawEvent,fantom,96,96,131,192
2024-06-10 00:00:00.000,wormhole,WithdrawEvent,sui,96,98,131,194
2024-03-04 00:00:00.000,layerzero,SendEvent,CoreDAO,109,109,130,218
2024-06-17 00:00:00.000,wormhole,WithdrawEvent,solana,90,87,130,177
2024-04-01 00:00:00.000,wormhole,WithdrawEvent,solana,108,93,128,201
2024-03-25 00:00:00.000,wormhole,WithdrawEvent,sui,58,58,127,116
2024-07-08 00:00:00.000,layerzero,SendEvent,Avalanche,106,106,127,212
2024-07-15 00:00:00.000,layerzero,SendEvent,Ethereum,113,114,126,227
2024-02-12 00:00:00.000,wormhole,WithdrawEvent,base,114,115,124,229
2024-04-29 00:00:00.000,layerzero,SendEvent,CoreDAO,45,45,122,90
2024-01-15 00:00:00.000,wormhole,WithdrawEvent,algorand,77,77,122,154
2024-05-27 00:00:00.000,wormhole,WithdrawEvent,sui,67,67,120,134
2024-01-15 00:00:00.000,layerzero,SendEvent,CoreDAO,117,117,120,234
2024-07-15 00:00:00.000,layerzero,SendEvent,Avalanche,92,92,118,184
2024-08-26 00:00:00.000,wormhole,WithdrawEvent,solana,39,27,118,66
2024-04-08 00:00:00.000,layerzero,SendEvent,CoreDAO,89,89,116,178
2024-05-06 00:00:00.000,wormhole,WithdrawEvent,solana,88,87,116,175
2024-05-20 00:00:00.000,wormhole,WithdrawEvent,solana,71,69,115,140
2024-01-15 00:00:00.000,wormhole,WithdrawEvent,klaytn,86,86,115,172
2024-03-04 00:00:00.000,wormhole,WithdrawEvent,bsc,104,104,115,208
2024-02-19 00:00:00.000,wormhole,WithdrawEvent,moonbeam,96,96,113,192
2024-08-12 00:00:00.000,wormhole,WithdrawEvent,solana,41,33,112,74
2024-02-05 00:00:00.000,wormhole,WithdrawEvent,optimism,105,104,111,209
2024-06-10 00:00:00.000,layerzero,SendEvent,Ethereum,98,99,110,197
2024-01-08 00:00:00.000,wormhole,WithdrawEvent,klaytn,67,66,108,133
2024-09-09 00:00:00.000,layerzero,SendEvent,Polygon,99,99,108,198
2024-02-26 00:00:00.000,wormhole,WithdrawEvent,polygon,88,88,108,176
2024-08-05 00:00:00.000,wormhole,WithdrawEvent,sui,58,58,107,116
2024-07-22 00:00:00.000,wormhole,WithdrawEvent,solana,52,46,106,98
2024-01-08 00:00:00.000,layerzero,SendEvent,CoreDAO,104,104,106,208
2024-02-26 00:00:00.000,wormhole,WithdrawEvent,bsc,85,85,104,170
2024-04-08 00:00:00.000,wormhole,WithdrawEvent,solana,78,77,104,155
2024-06-17 00:00:00.000,layerzero,SendEvent,Ethereum,100,100,104,200
2024-09-02 00:00:00.000,layerzero,SendEvent,Ethereum,94,96,102,190
2024-07-08 00:00:00.000,wormhole,WithdrawEvent,solana,55,50,102,105
2024-04-15 00:00:00.000,wormhole,WithdrawEvent,solana,78,71,102,149
2024-05-27 00:00:00.000,wormhole,WithdrawEvent,solana,58,49,102,107
2024-06-03 00:00:00.000,wormhole,WithdrawEvent,sui,62,63,102,125
2024-07-22 00:00:00.000,layerzero,SendEvent,Avalanche,84,84,102,168
2024-08-12 00:00:00.000,layerzero,SendEvent,Ethereum,88,86,102,174
2024-01-22 00:00:00.000,layerzero,SendEvent,CoreDAO,99,99,101,198
2024-02-12 00:00:00.000,layerzero,SendEvent,Optimism,96,95,101,191
2024-01-08 00:00:00.000,wormhole,WithdrawEvent,algorand,64,64,100,128
2024-07-15 00:00:00.000,wormhole,WithdrawEvent,solana,42,36,100,78
2024-07-29 00:00:00.000,wormhole,WithdrawEvent,solana,49,44,100,93
2024-02-12 00:00:00.000,wormhole,WithdrawEvent,arbitrum,90,90,98,180
2024-09-02 00:00:00.000,wormhole,WithdrawEvent,sui,43,43,98,86
2024-07-01 00:00:00.000,wormhole,WithdrawEvent,sui,56,56,97,112
2024-04-22 00:00:00.000,wormhole,WithdrawEvent,injective,91,90,97,181
2024-04-22 00:00:00.000,wormhole,WithdrawEvent,solana,73,70,96,143
2024-08-05 00:00:00.000,layerzero,SendEvent,Ethereum,80,79,96,159
2024-09-02 00:00:00.000,layerzero,SendEvent,Avalanche,81,82,95,163
2024-04-15 00:00:00.000,layerzero,SendEvent,Base,95,95,95,190
2024-08-26 00:00:00.000,layerzero,SendEvent,Ethereum,79,80,94,159
2024-08-19 00:00:00.000,layerzero,SendEvent,Avalanche,83,85,94,168
2024-03-04 00:00:00.000,wormhole,WithdrawEvent,sui,73,73,94,146
2024-03-04 00:00:00.000,wormhole,WithdrawEvent,polygon,78,76,93,154
2024-04-01 00:00:00.000,layerzero,SendEvent,CoreDAO,78,78,91,156
2024-09-02 00:00:00.000,wormhole,WithdrawEvent,solana,32,22,90,54
2024-05-20 00:00:00.000,wormhole,WithdrawEvent,polygon,70,71,89,141
2024-04-01 00:00:00.000,wormhole,WithdrawEvent,fantom,16,15,89,31
2024-02-26 00:00:00.000,wormhole,WithdrawEvent,celo,77,76,89,153
2024-03-04 00:00:00.000,wormhole,WithdrawEvent,celo,85,85,89,170
2024-04-22 00:00:00.000,wormhole,WithdrawEvent,wormchain,1,54,89,55
2024-08-19 00:00:00.000,wormhole,WithdrawEvent,solana,43,38,88,81
2024-06-03 00:00:00.000,layerzero,SendEvent,Ethereum,77,77,88,154
2024-01-22 00:00:00.000,wormhole,WithdrawEvent,klaytn,60,60,88,120
2024-06-10 00:00:00.000,wormhole,WithdrawEvent,solana,64,57,86,121
2024-08-12 00:00:00.000,wormhole,WithdrawEvent,sui,44,44,84,88
2024-02-12 00:00:00.000,wormhole,WithdrawEvent,wormchain,1,51,84,52
2024-03-11 00:00:00.000,wormhole,WithdrawEvent,celo,78,77,84,155
2024-05-13 00:00:00.000,wormhole,WithdrawEvent,wormchain,2,67,83,69
2024-07-08 00:00:00.000,layerzero,SendEvent,Ethereum,75,76,82,151
2024-03-11 00:00:00.000,layerzero,SendEvent,Ethereum,77,76,81,153
2024-01-29 00:00:00.000,layerzero,SendEvent,CoreDAO,79,79,79,158
2024-01-22 00:00:00.000,layerzero,SendEvent,Base,77,77,79,154
2024-07-01 00:00:00.000,wormhole,WithdrawEvent,arbitrum,49,49,79,98
2024-01-22 00:00:00.000,layerzero,SendEvent,Optimism,72,72,77,144
2024-01-29 00:00:00.000,layerzero,SendEvent,Base,66,66,76,132
2024-02-12 00:00:00.000,wormhole,WithdrawEvent,optimism,75,75,76,150
2024-08-26 00:00:00.000,layerzero,SendEvent,Avalanche,64,66,76,130
2024-05-27 00:00:00.000,layerzero,SendEvent,Ethereum,69,69,75,138
2024-09-09 00:00:00.000,wormhole,WithdrawEvent,sui,33,33,75,66
2024-01-15 00:00:00.000,layerzero,SendEvent,Base,74,74,75,148
2024-06-03 00:00:00.000,wormhole,WithdrawEvent,solana,57,53,75,110
2024-02-12 00:00:00.000,layerzero,SendEvent,CoreDAO,64,65,74,129
2024-04-08 00:00:00.000,layerzero,SendEvent,Base,70,69,72,139
2024-01-29 00:00:00.000,wormhole,WithdrawEvent,sei,3,57,72,60
2024-02-26 00:00:00.000,wormhole,WithdrawEvent,arbitrum,65,65,71,130
2024-01-08 00:00:00.000,layerzero,SendEvent,Optimism,68,68,71,136
2024-09-09 00:00:00.000,wormhole,WithdrawEvent,solana,29,25,71,54
2024-07-22 00:00:00.000,wormhole,WithdrawEvent,sui,37,37,71,74
2024-03-18 00:00:00.000,wormhole,WithdrawEvent,polygon,52,53,70,105
2024-02-26 00:00:00.000,layerzero,SendEvent,Optimism,65,64,69,129
2024-02-26 00:00:00.000,wormhole,WithdrawEvent,fantom,59,59,68,118
2024-07-29 00:00:00.000,wormhole,WithdrawEvent,sui,36,36,68,72
2024-06-24 00:00:00.000,wormhole,WithdrawEvent,polygon,42,44,67,86
2024-05-20 00:00:00.000,wormhole,WithdrawEvent,wormchain,1,63,67,64
2024-04-08 00:00:00.000,wormhole,WithdrawEvent,wormchain,1,51,64,52
2024-06-24 00:00:00.000,wormhole,WithdrawEvent,arbitrum,41,41,64,82
2024-08-26 00:00:00.000,wormhole,WithdrawEvent,sui,39,39,63,78
2024-01-29 00:00:00.000,wormhole,WithdrawEvent,klaytn,46,46,63,92
2024-08-19 00:00:00.000,wormhole,WithdrawEvent,sui,34,34,62,68
2024-08-12 00:00:00.000,layerzero,SendEvent,Avalanche,50,50,62,100
2024-03-11 00:00:00.000,layerzero,SendEvent,Base,49,49,60,98
2024-07-15 00:00:00.000,wormhole,WithdrawEvent,sui,27,27,60,54
2024-05-13 00:00:00.000,wormhole,WithdrawEvent,polygon,58,59,59,117
2024-02-05 00:00:00.000,wormhole,WithdrawEvent,sei,7,32,59,39
2024-06-10 00:00:00.000,wormhole,WithdrawEvent,wormchain,1,40,58,41
2024-07-08 00:00:00.000,wormhole,WithdrawEvent,sui,35,35,58,70
2024-02-26 00:00:00.000,layerzero,SendEvent,CoreDAO,50,50,58,100
2024-01-22 00:00:00.000,wormhole,WithdrawEvent,algorand,35,35,57,70
2024-03-18 00:00:00.000,wormhole,WithdrawEvent,wormchain,1,37,57,38
2024-01-15 00:00:00.000,layerzero,SendEvent,Optimism,52,53,57,105
2024-01-22 00:00:00.000,layerzero,SendEvent,Ethereum,47,47,57,94
2024-02-05 00:00:00.000,layerzero,SendEvent,Base,53,53,56,106
2024-03-18 00:00:00.000,wormhole,WithdrawEvent,bsc,50,50,56,100
2024-04-01 00:00:00.000,wormhole,WithdrawEvent,wormchain,2,37,54,39
2024-07-08 00:00:00.000,wormhole,WithdrawEvent,arbitrum,36,36,54,72
2024-04-01 00:00:00.000,wormhole,WithdrawEvent,bsc,53,53,54,106
2024-03-11 00:00:00.000,wormhole,WithdrawEvent,bsc,46,47,53,93
2024-02-19 00:00:00.000,wormhole,WithdrawEvent,arbitrum,50,50,52,100
2024-04-15 00:00:00.000,wormhole,WithdrawEvent,wormchain,2,33,52,35
2024-02-19 00:00:00.000,layerzero,SendEvent,CoreDAO,52,48,52,100
2024-06-24 00:00:00.000,wormhole,WithdrawEvent,wormchain,1,48,52,49
2024-06-03 00:00:00.000,wormhole,WithdrawEvent,polygon,45,45,51,90
2024-02-19 00:00:00.000,wormhole,WithdrawEvent,base,48,48,51,96
2024-07-01 00:00:00.000,wormhole,WithdrawEvent,wormchain,1,26,51,27
2024-06-10 00:00:00.000,wormhole,WithdrawEvent,polygon,48,49,51,97
2024-03-11 00:00:00.000,wormhole,WithdrawEvent,polygon,39,39,50,78
2024-01-29 00:00:00.000,wormhole,WithdrawEvent,injective,46,46,50,92
2024-01-15 00:00:00.000,layerzero,SendEvent,Ethereum,43,41,49,84
2024-09-09 00:00:00.000,layerzero,SendEvent,Ethereum,42,42,49,84
2024-02-12 00:00:00.000,wormhole,WithdrawEvent,moonbeam,40,40,48,80
2024-03-11 00:00:00.000,wormhole,WithdrawEvent,wormchain,1,28,48,29
2024-02-12 00:00:00.000,layerzero,SendEvent,Ethereum,36,37,48,73
2024-04-08 00:00:00.000,wormhole,WithdrawEvent,arbitrum,46,46,48,92
2024-03-25 00:00:00.000,wormhole,WithdrawEvent,wormchain,1,14,48,15
2024-03-04 00:00:00.000,layerzero,SendEvent,Ethereum,41,40,47,81
2024-06-17 00:00:00.000,wormhole,WithdrawEvent,wormchain,1,29,47,30
2024-06-03 00:00:00.000,wormhole,WithdrawEvent,wormchain,1,35,47,36
2024-04-01 00:00:00.000,wormhole,WithdrawEvent,polygon,42,40,47,82
2024-06-17 00:00:00.000,wormhole,WithdrawEvent,polygon,45,46,46,91
2024-02-05 00:00:00.000,layerzero,SendEvent,Ethereum,37,37,45,74
2024-05-06 00:00:00.000,wormhole,WithdrawEvent,wormchain,1,15,45,16
2024-01-08 00:00:00.000,layerzero,SendEvent,Ethereum,38,38,45,76
2024-01-29 00:00:00.000,wormhole,WithdrawEvent,algorand,28,28,45,56
2024-06-17 00:00:00.000,wormhole,WithdrawEvent,arbitrum,42,42,44,84
2024-02-19 00:00:00.000,wormhole,WithdrawEvent,optimism,44,44,44,88
2024-02-19 00:00:00.000,wormhole,WithdrawEvent,wormchain,1,24,44,25
2024-02-12 00:00:00.000,wormhole,WithdrawEvent,avalanche,44,44,44,88
2024-07-22 00:00:00.000,wormhole,WithdrawEvent,wormchain,1,21,43,22
2024-01-22 00:00:00.000,wormhole,WithdrawEvent,ethereum,31,32,43,63
2024-02-26 00:00:00.000,wormhole,WithdrawEvent,base,40,40,42,80
2024-03-11 00:00:00.000,wormhole,WithdrawEvent,arbitrum,36,38,42,74
2024-02-26 00:00:00.000,layerzero,SendEvent,Base,19,19,41,38
2024-01-22 00:00:00.000,wormhole,WithdrawEvent,sei,6,35,41,41
2024-04-08 00:00:00.000,wormhole,WithdrawEvent,bsc,37,37,41,74
2024-01-29 00:00:00.000,layerzero,SendEvent,Ethereum,35,35,41,70
2024-03-18 00:00:00.000,wormhole,WithdrawEvent,celo,27,27,40,54
2024-03-04 00:00:00.000,layerzero,SendEvent,Base,32,32,40,64
2024-01-29 00:00:00.000,wormhole,WithdrawEvent,ethereum,34,35,40,69
2024-04-22 00:00:00.000,layerzero,SendEvent,Base,39,39,39,78
2024-02-19 00:00:00.000,wormhole,WithdrawEvent,avalanche,35,35,39,70
2024-03-25 00:00:00.000,wormhole,WithdrawEvent,arbitrum,34,35,38,69
2024-02-05 00:00:00.000,layerzero,SendEvent,CoreDAO,38,38,38,76
2024-01-29 00:00:00.000,layerzero,SendEvent,Optimism,36,36,38,72
2024-05-27 00:00:00.000,wormhole,WithdrawEvent,ethereum,14,12,37,26
2024-02-19 00:00:00.000,layerzero,SendEvent,Ethereum,34,33,36,67
2024-03-25 00:00:00.000,wormhole,WithdrawEvent,polygon,32,30,36,62
2024-02-26 00:00:00.000,wormhole,WithdrawEvent,optimism,36,36,36,72
2024-03-04 00:00:00.000,wormhole,WithdrawEvent,arbitrum,35,35,36,70
2024-03-25 00:00:00.000,wormhole,WithdrawEvent,bsc,28,27,36,55
2024-04-01 00:00:00.000,wormhole,WithdrawEvent,arbitrum,33,33,35,66
2024-03-04 00:00:00.000,wormhole,WithdrawEvent,fantom,30,30,35,60
2024-02-05 00:00:00.000,wormhole,WithdrawEvent,ethereum,29,30,35,59
2024-07-29 00:00:00.000,wormhole,WithdrawEvent,arbitrum,22,22,35,44
2024-07-08 00:00:00.000,wormhole,WithdrawEvent,polygon,28,26,34,54
2024-07-15 00:00:00.000,wormhole,WithdrawEvent,arbitrum,28,28,34,56
2024-06-17 00:00:00.000,wormhole,WithdrawEvent,base,32,32,34,64
2024-03-25 00:00:00.000,layerzero,SendEvent,Optimism,32,32,33,64
2024-01-08 00:00:00.000,wormhole,WithdrawEvent,ethereum,25,26,33,51
2024-02-12 00:00:00.000,wormhole,WithdrawEvent,sei,7,16,33,23
2024-06-17 00:00:00.000,wormhole,WithdrawEvent,injective,32,32,32,64
2024-06-24 00:00:00.000,mover,SwapOutEvent,Polygon,30,30,32,60
2024-03-04 00:00:00.000,mover,SwapInEvent,aptos,31,31,31,62
2024-03-25 00:00:00.000,wormhole,WithdrawEvent,optimism,27,28,31,55
2024-03-11 00:00:00.000,wormhole,WithdrawEvent,base,22,23,30,45
2024-04-08 00:00:00.000,wormhole,WithdrawEvent,base,29,29,30,58
2024-03-18 00:00:00.000,wormhole,WithdrawEvent,arbitrum,29,29,30,58
2024-02-19 00:00:00.000,mover,SwapInEvent,aptos,29,30,30,59
2024-02-19 00:00:00.000,wormhole,WithdrawEvent,sei,3,16,30,19
2024-04-01 00:00:00.000,wormhole,WithdrawEvent,optimism,28,28,29,56
2024-02-12 00:00:00.000,wormhole,WithdrawEvent,ethereum,23,23,29,46
2024-06-03 00:00:00.000,wormhole,WithdrawEvent,arbitrum,28,28,29,56
2024-02-19 00:00:00.000,layerzero,SendEvent,Base,19,19,28,38
2024-01-15 00:00:00.000,wormhole,WithdrawEvent,sei,2,21,28,23
2024-04-22 00:00:00.000,wormhole,WithdrawEvent,polygon,26,25,28,51
2024-02-12 00:00:00.000,layerzero,SendEvent,Base,25,25,27,50
2024-05-27 00:00:00.000,wormhole,WithdrawEvent,wormchain,1,15,27,16
2024-04-22 00:00:00.000,wormhole,WithdrawEvent,ethereum,7,7,27,14
2024-03-25 00:00:00.000,wormhole,WithdrawEvent,celo,21,21,26,42
2024-06-24 00:00:00.000,wormhole,WithdrawEvent,base,23,23,26,46
2024-03-04 00:00:00.000,wormhole,WithdrawEvent,wormchain,1,20,26,21
2024-07-15 00:00:00.000,wormhole,WithdrawEvent,wormchain,1,11,26,12
2024-05-13 00:00:00.000,wormhole,WithdrawEvent,arbitrum,22,21,26,43
2024-06-17 00:00:00.000,wormhole,WithdrawEvent,bsc,24,24,26,48
2024-06-17 00:00:00.000,mover,SwapOutEvent,Polygon,24,24,26,48
2024-07-01 00:00:00.000,wormhole,WithdrawEvent,polygon,21,20,25,41
2024-07-08 00:00:00.000,wormhole,WithdrawEvent,wormchain,1,13,25,14
2024-01-15 00:00:00.000,wormhole,WithdrawEvent,ethereum,24,24,25,48
2024-05-13 00:00:00.000,wormhole,WithdrawEvent,ethereum,12,12,25,24
2024-06-10 00:00:00.000,wormhole,WithdrawEvent,arbitrum,21,21,25,42
2024-04-01 00:00:00.000,layerzero,SendEvent,Optimism,25,25,25,50
2024-02-12 00:00:00.000,mover,SwapInEvent,aptos,21,25,25,46
2024-02-26 00:00:00.000,layerzero,SendEvent,Ethereum,19,19,24,38
2024-03-25 00:00:00.000,wormhole,WithdrawEvent,base,17,18,24,35
2024-03-25 00:00:00.000,wormhole,WithdrawEvent,fantom,10,10,24,20
2024-03-04 00:00:00.000,mover,SwapOutEvent,Polygon,23,23,24,46
2024-05-06 00:00:00.000,wormhole,WithdrawEvent,arbitrum,21,20,24,41
2024-05-20 00:00:00.000,wormhole,WithdrawEvent,arbitrum,21,17,24,38
2024-03-18 00:00:00.000,mover,SwapInEvent,aptos,21,21,24,42
2024-04-01 00:00:00.000,wormhole,WithdrawEvent,ethereum,16,14,24,30
2024-06-24 00:00:00.000,wormhole,WithdrawEvent,injective,23,23,24,46
2024-04-15 00:00:00.000,wormhole,WithdrawEvent,arbitrum,18,17,23,35
2024-04-08 00:00:00.000,wormhole,WithdrawEvent,celo,12,11,23,23
2024-02-05 00:00:00.000,wormhole,WithdrawEvent,injective,22,22,23,44
2024-04-08 00:00:00.000,wormhole,WithdrawEvent,optimism,22,22,22,44
2024-04-29 00:00:00.000,mover,SwapInEvent,aptos,20,20,22,40
2024-04-29 00:00:00.000,wormhole,WithdrawEvent,optimism,16,16,22,32
2024-03-18 00:00:00.000,wormhole,WithdrawEvent,fantom,15,17,22,32
2024-03-11 00:00:00.000,wormhole,WithdrawEvent,optimism,21,21,22,42
2024-05-27 00:00:00.000,wormhole,WithdrawEvent,polygon,19,19,22,38
2024-02-05 00:00:00.000,wormhole,WithdrawEvent,klaytn,20,20,22,40
2024-04-01 00:00:00.000,wormhole,WithdrawEvent,base,22,21,22,43
2024-07-08 00:00:00.000,wormhole,WithdrawEvent,optimism,15,15,22,30
2024-04-15 00:00:00.000,wormhole,WithdrawEvent,celo,12,10,22,22
2024-04-29 00:00:00.000,wormhole,WithdrawEvent,bsc,16,16,22,32
2024-05-20 00:00:00.000,wormhole,WithdrawEvent,optimism,19,19,21,38
2024-04-29 00:00:00.000,wormhole,WithdrawEvent,wormchain,1,13,21,14
2024-06-03 00:00:00.000,wormhole,WithdrawEvent,optimism,19,19,21,38
2024-01-22 00:00:00.000,mover,SwapInEvent,aptos,15,15,21,30
2024-03-18 00:00:00.000,wormhole,WithdrawEvent,optimism,18,18,21,36
2024-03-25 00:00:00.000,wormhole,WithdrawEvent,ethereum,13,13,21,26
2024-05-20 00:00:00.000,wormhole,WithdrawEvent,ethereum,10,10,21,20
2024-06-03 00:00:00.000,wormhole,WithdrawEvent,bsc,16,16,21,32
2024-03-18 00:00:00.000,wormhole,WithdrawEvent,ethereum,15,15,20,30
2024-04-15 00:00:00.000,wormhole,WithdrawEvent,ethereum,14,15,20,29
2024-02-26 00:00:00.000,wormhole,WithdrawEvent,ethereum,14,13,20,27
2024-02-26 00:00:00.000,wormhole,WithdrawEvent,moonbeam,16,16,20,32
2024-08-12 00:00:00.000,wormhole,WithdrawEvent,wormchain,1,5,20,6
2024-06-17 00:00:00.000,wormhole,WithdrawEvent,optimism,17,17,20,34
2024-05-06 00:00:00.000,wormhole,WithdrawEvent,polygon,18,18,20,36
2024-05-27 00:00:00.000,wormhole,WithdrawEvent,arbitrum,19,19,20,38
2024-04-22 00:00:00.000,wormhole,WithdrawEvent,bsc,20,20,20,40
2024-04-29 00:00:00.000,wormhole,WithdrawEvent,arbitrum,18,18,20,36
2024-03-04 00:00:00.000,wormhole,WithdrawEvent,base,20,20,20,40
2024-06-10 00:00:00.000,wormhole,WithdrawEvent,injective,19,19,19,38
2024-07-01 00:00:00.000,wormhole,WithdrawEvent,base,18,18,19,36
2024-02-19 00:00:00.000,wormhole,WithdrawEvent,klaytn,19,19,19,38
2024-03-11 00:00:00.000,wormhole,WithdrawEvent,ethereum,12,12,19,24
2024-04-08 00:00:00.000,wormhole,WithdrawEvent,polygon,17,17,19,34
2024-06-17 00:00:00.000,mover,SwapInEvent,aptos,17,16,19,33
2024-05-06 00:00:00.000,wormhole,WithdrawEvent,optimism,16,16,18,32
2024-02-26 00:00:00.000,wormhole,WithdrawEvent,wormchain,1,16,18,17
2024-03-04 00:00:00.000,mover,SwapOutEvent,ZkSync,18,18,18,36
2024-07-29 00:00:00.000,wormhole,WithdrawEvent,ethereum,12,12,18,24
2024-08-26 00:00:00.000,wormhole,WithdrawEvent,ethereum,14,14,18,28
2024-02-19 00:00:00.000,wormhole,WithdrawEvent,ethereum,15,15,18,30
2024-05-06 00:00:00.000,wormhole,WithdrawEvent,base,18,18,18,36
2024-02-26 00:00:00.000,wormhole,WithdrawEvent,sei,1,12,18,13
2024-04-29 00:00:00.000,wormhole,WithdrawEvent,celo,6,6,17,12
2024-03-18 00:00:00.000,wormhole,WithdrawEvent,base,16,16,17,32
2024-04-22 00:00:00.000,wormhole,WithdrawEvent,celo,14,14,17,28
2024-06-03 00:00:00.000,wormhole,WithdrawEvent,base,17,17,17,34
2024-05-27 00:00:00.000,wormhole,WithdrawEvent,optimism,15,15,16,30
2024-04-29 00:00:00.000,wormhole,WithdrawEvent,ethereum,4,5,16,9
2024-06-10 00:00:00.000,wormhole,WithdrawEvent,base,16,16,16,32
2024-04-15 00:00:00.000,wormhole,WithdrawEvent,optimism,16,15,16,31
2024-03-11 00:00:00.000,mover,SwapInEvent,aptos,12,12,16,24
2024-04-29 00:00:00.000,wormhole,WithdrawEvent,polygon,13,13,16,26
2024-08-19 00:00:00.000,mover,SwapInEvent,aptos,15,15,16,30
2024-04-29 00:00:00.000,layerzero,SendEvent,Base,15,15,16,30
2024-03-04 00:00:00.000,wormhole,WithdrawEvent,ethereum,14,14,15,28
2024-04-01 00:00:00.000,wormhole,WithdrawEvent,celo,11,11,15,22
2024-02-26 00:00:00.000,wormhole,WithdrawEvent,avalanche,12,12,15,24
2024-03-18 00:00:00.000,wormhole,WithdrawEvent,avalanche,13,14,15,27
2024-06-24 00:00:00.000,wormhole,WithdrawEvent,avalanche,13,13,15,26
2024-03-11 00:00:00.000,wormhole,WithdrawEvent,avalanche,13,14,15,27
2024-03-04 00:00:00.000,wormhole,WithdrawEvent,optimism,15,15,15,30
2024-07-01 00:00:00.000,wormhole,WithdrawEvent,ethereum,13,13,15,26
2024-04-15 00:00:00.000,wormhole,WithdrawEvent,polygon,14,13,15,27
2024-05-06 00:00:00.000,wormhole,WithdrawEvent,bsc,14,14,15,28
2024-09-02 00:00:00.000,wormhole,WithdrawEvent,wormchain,1,7,14,8
2024-02-19 00:00:00.000,mover,SwapOutEvent,ZkSync,14,11,14,25
2024-06-03 00:00:00.000,wormhole,WithdrawEvent,ethereum,11,10,14,21
2024-08-12 00:00:00.000,wormhole,WithdrawEvent,arbitrum,10,11,14,21
2024-05-06 00:00:00.000,wormhole,WithdrawEvent,ethereum,10,10,14,20
2024-03-04 00:00:00.000,wormhole,WithdrawEvent,moonbeam,10,10,14,20
2024-09-02 00:00:00.000,mover,SwapInEvent,aptos,14,14,14,28
2024-04-22 00:00:00.000,wormhole,WithdrawEvent,arbitrum,14,14,14,28
2024-05-27 00:00:00.000,wormhole,WithdrawEvent,base,12,12,14,24
2024-05-27 00:00:00.000,wormhole,WithdrawEvent,bsc,13,13,14,26
2024-03-11 00:00:00.000,celer_cbridge,MintEvent,Aptos,10,10,14,20
2024-02-19 00:00:00.000,mover,SwapOutEvent,Optimism,13,10,14,23
2024-02-26 00:00:00.000,mover,SwapInEvent,aptos,11,12,14,23
2024-06-10 00:00:00.000,wormhole,WithdrawEvent,ethereum,12,11,13,23
2024-07-29 00:00:00.000,wormhole,WithdrawEvent,wormchain,1,7,13,8
2024-07-22 00:00:00.000,wormhole,WithdrawEvent,ethereum,10,10,13,20
2024-06-17 00:00:00.000,mover,SwapOutEvent,Arbitrum,12,12,13,24
2024-08-26 00:00:00.000,wormhole,WithdrawEvent,wormchain,1,4,13,5
2024-08-05 00:00:00.000,wormhole,WithdrawEvent,arbitrum,12,12,13,24
2024-06-24 00:00:00.000,wormhole,WithdrawEvent,bsc,11,11,13,22
2024-05-20 00:00:00.000,wormhole,WithdrawEvent,bsc,12,12,13,24
2024-04-22 00:00:00.000,wormhole,WithdrawEvent,base,12,12,13,24
2024-08-19 00:00:00.000,wormhole,WithdrawEvent,polygon,13,13,13,26
2024-07-29 00:00:00.000,wormhole,WithdrawEvent,polygon,13,13,13,26
2024-04-22 00:00:00.000,wormhole,WithdrawEvent,optimism,13,13,13,26
2024-06-24 00:00:00.000,mover,SwapInEvent,aptos,10,10,13,20
2024-08-26 00:00:00.000,wormhole,WithdrawEvent,polygon,9,9,13,18
2024-06-10 00:00:00.000,wormhole,WithdrawEvent,optimism,12,12,12,24
2024-06-24 00:00:00.000,wormhole,WithdrawEvent,ethereum,10,10,12,20
2024-04-15 00:00:00.000,wormhole,WithdrawEvent,bsc,12,11,12,23
2024-04-29 00:00:00.000,wormhole,WithdrawEvent,moonbeam,4,4,12,8
2024-07-22 00:00:00.000,wormhole,WithdrawEvent,polygon,12,12,12,24
2024-06-03 00:00:00.000,wormhole,WithdrawEvent,fantom,11,11,12,22
2024-07-22 00:00:00.000,wormhole,WithdrawEvent,arbitrum,9,9,12,18
2024-05-13 00:00:00.000,wormhole,WithdrawEvent,bsc,8,8,12,16
2024-01-08 00:00:00.000,wormhole,WithdrawEvent,injective,11,11,12,22
2024-01-15 00:00:00.000,celer_cbridge,MintEvent,Aptos,7,7,12,14
2024-03-11 00:00:00.000,wormhole,WithdrawEvent,fantom,11,11,12,22
2024-01-08 00:00:00.000,wormhole,WithdrawEvent,sei,3,11,12,14
2024-08-19 00:00:00.000,wormhole,WithdrawEvent,arbitrum,10,10,11,20
2024-01-15 00:00:00.000,wormhole,WithdrawEvent,injective,11,11,11,22
2024-07-22 00:00:00.000,wormhole,WithdrawEvent,optimism,10,10,11,20
2024-03-11 00:00:00.000,wormhole,WithdrawEvent,moonbeam,8,8,11,16
2024-08-05 00:00:00.000,wormhole,WithdrawEvent,ethereum,8,8,11,16
2024-07-15 00:00:00.000,wormhole,WithdrawEvent,polygon,10,10,11,20
2024-06-10 00:00:00.000,wormhole,WithdrawEvent,fantom,10,10,11,20
2024-07-08 00:00:00.000,wormhole,WithdrawEvent,base,11,11,11,22
2024-02-05 00:00:00.000,wormhole,WithdrawEvent,algorand,6,6,11,12
2024-04-01 00:00:00.000,mover,SwapInEvent,aptos,10,10,11,20
2024-08-05 00:00:00.000,wormhole,WithdrawEvent,bsc,10,10,10,20
2024-04-29 00:00:00.000,wormhole,WithdrawEvent,base,9,9,10,18
2024-07-22 00:00:00.000,wormhole,WithdrawEvent,base,9,9,10,18
2024-08-12 00:00:00.000,wormhole,WithdrawEvent,ethereum,10,10,10,20
2024-07-29 00:00:00.000,wormhole,WithdrawEvent,bsc,7,7,10,14
2024-03-11 00:00:00.000,wormhole,WithdrawEvent,sei,3,6,10,9
2024-05-13 00:00:00.000,wormhole,WithdrawEvent,base,10,10,10,20
2024-05-06 00:00:00.000,mover,SwapInEvent,aptos,10,10,10,20
2024-01-29 00:00:00.000,celer_cbridge,MintEvent,Aptos,6,6,10,12
2024-02-12 00:00:00.000,mover,SwapOutEvent,ZkSync,10,8,10,18
2024-06-24 00:00:00.000,wormhole,WithdrawEvent,optimism,10,10,10,20
2024-08-19 00:00:00.000,wormhole,WithdrawEvent,ethereum,5,5,10,10
2024-06-17 00:00:00.000,wormhole,WithdrawEvent,ethereum,8,8,10,16
2024-05-20 00:00:00.000,wormhole,WithdrawEvent,celo,4,4,10,8
2024-05-27 00:00:00.000,wormhole,WithdrawEvent,avalanche,10,10,10,20
2024-07-22 00:00:00.000,mover,SwapInEvent,aptos,9,9,10,18
2024-07-01 00:00:00.000,wormhole,WithdrawEvent,bsc,7,7,9,14
2024-01-22 00:00:00.000,wormhole,WithdrawEvent,injective,8,8,9,16
2024-08-26 00:00:00.000,wormhole,WithdrawEvent,arbitrum,8,8,9,16
2024-07-08 00:00:00.000,wormhole,WithdrawEvent,ethereum,8,8,9,16
2024-07-08 00:00:00.000,wormhole,WithdrawEvent,bsc,9,9,9,18
2024-04-29 00:00:00.000,wormhole,WithdrawEvent,sei,1,2,9,3
2024-08-12 00:00:00.000,wormhole,WithdrawEvent,bsc,8,8,9,16
2024-07-15 00:00:00.000,wormhole,WithdrawEvent,base,9,9,9,18
2024-04-15 00:00:00.000,wormhole,WithdrawEvent,injective,9,9,9,18
2024-08-12 00:00:00.000,mover,SwapInEvent,aptos,8,8,9,16
2024-06-10 00:00:00.000,wormhole,WithdrawEvent,bsc,8,8,8,16
2024-05-13 00:00:00.000,wormhole,WithdrawEvent,fantom,8,8,8,16
2024-09-02 00:00:00.000,wormhole,WithdrawEvent,arbitrum,8,8,8,16
2024-04-15 00:00:00.000,wormhole,WithdrawEvent,base,8,8,8,16
2024-01-15 00:00:00.000,mover,SwapInEvent,aptos,7,7,8,14
2024-08-19 00:00:00.000,wormhole,WithdrawEvent,bsc,5,5,8,10
2024-05-13 00:00:00.000,wormhole,WithdrawEvent,optimism,8,8,8,16
2024-01-22 00:00:00.000,mover,SwapOutEvent,ZkSync,6,6,8,12
2024-03-04 00:00:00.000,wormhole,WithdrawEvent,avalanche,8,8,8,16
2024-07-01 00:00:00.000,mover,SwapInEvent,aptos,6,6,8,12
2024-09-02 00:00:00.000,wormhole,WithdrawEvent,ethereum,4,4,8,8
2024-03-11 00:00:00.000,mover,SwapOutEvent,Optimism,6,6,8,12
2024-08-19 00:00:00.000,wormhole,WithdrawEvent,wormchain,1,3,8,4
2024-05-20 00:00:00.000,wormhole,WithdrawEvent,base,8,8,8,16
2024-06-17 00:00:00.000,layerzero,SendEvent,Base,8,8,8,16
2024-03-04 00:00:00.000,mover,SwapOutEvent,Arbitrum,4,4,8,8
2024-06-17 00:00:00.000,wormhole,WithdrawEvent,moonbeam,6,6,8,12
2024-04-08 00:00:00.000,wormhole,WithdrawEvent,avalanche,8,8,8,16
2024-01-29 00:00:00.000,mover,SwapInEvent,aptos,7,7,8,14
2024-03-25 00:00:00.000,wormhole,WithdrawEvent,avalanche,8,8,8,16
2024-09-09 00:00:00.000,wormhole,WithdrawEvent,arbitrum,8,8,8,16
2024-03-25 00:00:00.000,mover,SwapInEvent,aptos,8,8,8,16
2024-05-20 00:00:00.000,wormhole,WithdrawEvent,avalanche,8,8,8,16
2024-04-01 00:00:00.000,wormhole,WithdrawEvent,avalanche,7,7,7,14
2024-04-15 00:00:00.000,layerzero,SendEvent,Polygon zkEVM,7,7,7,14
2024-06-17 00:00:00.000,wormhole,WithdrawEvent,fantom,7,7,7,14
2024-04-22 00:00:00.000,mover,SwapInEvent,aptos,6,6,7,12
2024-09-09 00:00:00.000,wormhole,WithdrawEvent,ethereum,6,6,7,12
2024-05-27 00:00:00.000,wormhole,WithdrawEvent,fantom,7,7,7,14
2024-07-15 00:00:00.000,wormhole,WithdrawEvent,bsc,5,5,7,10
2024-06-17 00:00:00.000,mover,SwapOutEvent,Optimism,6,6,7,12
2024-06-24 00:00:00.000,wormhole,WithdrawEvent,moonbeam,4,4,7,8
2024-03-25 00:00:00.000,mover,SwapOutEvent,Polygon,6,6,7,12
2024-01-22 00:00:00.000,mover,SwapOutEvent,Arbitrum,5,5,7,10
2024-08-05 00:00:00.000,wormhole,WithdrawEvent,polygon,5,5,7,10
2024-03-18 00:00:00.000,celer_cbridge,BurnEvent,BSC,7,7,7,14
2024-04-15 00:00:00.000,mover,SwapInEvent,aptos,7,7,7,14
2024-03-11 00:00:00.000,mover,SwapOutEvent,ZkSync,7,7,7,14
2024-02-12 00:00:00.000,wormhole,WithdrawEvent,klaytn,6,6,6,12
2024-09-09 00:00:00.000,wormhole,WithdrawEvent,wormchain,1,4,6,5
2024-06-24 00:00:00.000,mover,SwapOutEvent,Arbitrum,6,6,6,12
2024-02-12 00:00:00.000,mover,SwapOutEvent,Optimism,5,5,6,10
2024-02-05 00:00:00.000,mover,SwapInEvent,aptos,6,6,6,12
2024-07-29 00:00:00.000,mover,SwapInEvent,aptos,5,5,6,10
2024-09-02 00:00:00.000,wormhole,WithdrawEvent,base,6,6,6,12
2024-08-26 00:00:00.000,mover,SwapInEvent,aptos,6,6,6,12
2024-07-29 00:00:00.000,celer_cbridge,BurnEvent,BSC,2,2,6,4
2024-04-29 00:00:00.000,wormhole,WithdrawEvent,fantom,5,5,6,10
2024-07-15 00:00:00.000,wormhole,WithdrawEvent,optimism,6,6,6,12
2024-03-11 00:00:00.000,wormhole,WithdrawEvent,injective,4,4,6,8
2024-06-03 00:00:00.000,wormhole,WithdrawEvent,celo,2,2,6,4
2024-08-26 00:00:00.000,wormhole,WithdrawEvent,optimism,6,6,6,12
2024-07-01 00:00:00.000,wormhole,WithdrawEvent,optimism,6,6,6,12
2024-06-17 00:00:00.000,wormhole,WithdrawEvent,celo,4,4,6,8
2024-06-03 00:00:00.000,mover,SwapInEvent,aptos,6,6,6,12
2024-05-13 00:00:00.000,wormhole,WithdrawEvent,avalanche,5,5,6,10
2024-06-17 00:00:00.000,wormhole,WithdrawEvent,sei,1,6,6,7
2024-03-25 00:00:00.000,wormhole,WithdrawEvent,moonbeam,3,3,6,6
2024-08-19 00:00:00.000,wormhole,WithdrawEvent,optimism,3,3,6,6
2024-04-01 00:00:00.000,mover,SwapOutEvent,ZkSync,5,5,6,10
2024-07-15 00:00:00.000,wormhole,WithdrawEvent,ethereum,4,4,5,8
2024-06-24 00:00:00.000,wormhole,WithdrawEvent,celo,4,4,5,8
2024-07-15 00:00:00.000,wormhole,WithdrawEvent,fantom,5,5,5,10
2024-03-25 00:00:00.000,celer_cbridge,BurnEvent,BSC,5,5,5,10
2024-08-05 00:00:00.000,wormhole,WithdrawEvent,optimism,5,5,5,10
2024-05-06 00:00:00.000,wormhole,WithdrawEvent,celo,5,5,5,10
2024-07-22 00:00:00.000,wormhole,WithdrawEvent,fantom,5,5,5,10
2024-07-15 00:00:00.000,mover,SwapInEvent,aptos,5,5,5,10
2024-01-08 00:00:00.000,mover,SwapInEvent,aptos,5,5,5,10
2024-03-18 00:00:00.000,mover,SwapOutEvent,BNB,5,5,5,10
2024-04-22 00:00:00.000,wormhole,WithdrawEvent,fantom,5,5,5,10
2024-05-27 00:00:00.000,layerzero,SendEvent,CoreDAO,5,5,5,10
2024-08-19 00:00:00.000,wormhole,WithdrawEvent,base,5,5,5,10
2024-03-25 00:00:00.000,celer_cbridge,MintEvent,Aptos,5,5,5,10
2024-03-18 00:00:00.000,celer_cbridge,MintEvent,Aptos,4,4,5,8
2024-03-18 00:00:00.000,wormhole,WithdrawEvent,moonbeam,3,3,5,6
2024-08-05 00:00:00.000,wormhole,WithdrawEvent,wormchain,1,2,5,3
2024-06-10 00:00:00.000,layerzero,SendEvent,Base,4,4,5,8
2024-06-03 00:00:00.000,wormhole,WithdrawEvent,avalanche,5,5,5,10
2024-03-11 00:00:00.000,mover,SwapOutEvent,Arbitrum,5,5,5,10
2024-08-26 00:00:00.000,wormhole,WithdrawEvent,base,5,5,5,10
2024-08-12 00:00:00.000,wormhole,WithdrawEvent,polygon,5,5,5,10
2024-05-06 00:00:00.000,layerzero,SendEvent,CoreDAO,5,5,5,10
2024-01-22 00:00:00.000,celer_cbridge,MintEvent,Aptos,5,5,5,10
2024-06-03 00:00:00.000,wormhole,WithdrawEvent,moonbeam,3,3,5,6
2024-07-29 00:00:00.000,wormhole,WithdrawEvent,base,4,4,4,8
2024-06-17 00:00:00.000,wormhole,WithdrawEvent,avalanche,4,4,4,8
2024-09-09 00:00:00.000,wormhole,WithdrawEvent,celo,1,2,4,3
2024-09-09 00:00:00.000,wormhole,WithdrawEvent,bsc,3,3,4,6
2024-01-08 00:00:00.000,celer_cbridge,BurnEvent,Ethereum,3,3,4,6
2024-03-25 00:00:00.000,mover,SwapOutEvent,Optimism,4,4,4,8
2024-05-13 00:00:00.000,wormhole,WithdrawEvent,injective,4,4,4,8
2024-01-22 00:00:00.000,mover,SwapOutEvent,Optimism,2,2,4,4
2024-06-24 00:00:00.000,mover,SwapOutEvent,Optimism,4,4,4,8
2024-09-02 00:00:00.000,wormhole,WithdrawEvent,celo,1,1,4,2
2024-04-15 00:00:00.000,mover,SwapOutEvent,ZkSync,4,4,4,8
2024-01-08 00:00:00.000,wormhole,WithdrawEvent,near,3,3,4,6
2024-07-08 00:00:00.000,mover,SwapInEvent,aptos,4,4,4,8
2024-07-22 00:00:00.000,mover,SwapOutEvent,Arbitrum,4,4,4,8
2024-04-15 00:00:00.000,wormhole,WithdrawEvent,fantom,4,4,4,8
2024-03-18 00:00:00.000,mover,SwapOutEvent,ZkSync,4,4,4,8
2024-02-05 00:00:00.000,celer_cbridge,MintEvent,Aptos,3,3,4,6
2024-05-06 00:00:00.000,wormhole,WithdrawEvent,fantom,4,4,4,8
2024-09-09 00:00:00.000,mover,SwapInEvent,aptos,4,4,4,8
2024-03-18 00:00:00.000,mover,SwapOutEvent,Arbitrum,4,4,4,8
2024-03-04 00:00:00.000,wormhole,WithdrawEvent,sei,1,2,4,3
2024-04-01 00:00:00.000,celer_cbridge,MintEvent,Aptos,4,4,4,8
2024-08-05 00:00:00.000,wormhole,WithdrawEvent,base,4,4,4,8
2024-03-04 00:00:00.000,mover,SwapOutEvent,Optimism,4,4,4,8
2024-03-25 00:00:00.000,mover,SwapOutEvent,Arbitrum,4,4,4,8
2024-05-20 00:00:00.000,celer_cbridge,BurnEvent,Ethereum,3,3,4,6
2024-04-15 00:00:00.000,mover,SwapOutEvent,Arbitrum,4,4,4,8
2024-06-10 00:00:00.000,mover,SwapInEvent,aptos,3,3,4,6
2024-07-22 00:00:00.000,wormhole,WithdrawEvent,celo,4,4,4,8
2024-07-29 00:00:00.000,wormhole,WithdrawEvent,optimism,4,4,4,8
2024-05-06 00:00:00.000,mover,SwapOutEvent,ZkSync,4,4,4,8
2024-06-17 00:00:00.000,wormhole,WithdrawEvent,klaytn,3,4,4,7
2024-01-22 00:00:00.000,celer_cbridge,BurnEvent,Ethereum,2,2,4,4
2024-02-26 00:00:00.000,wormhole,WithdrawEvent,klaytn,4,4,4,8
2024-07-22 00:00:00.000,wormhole,WithdrawEvent,bsc,4,4,4,8
2024-09-09 00:00:00.000,wormhole,WithdrawEvent,optimism,3,3,4,6
2024-03-11 00:00:00.000,wormhole,WithdrawEvent,klaytn,3,3,4,6
2024-06-03 00:00:00.000,mover,SwapOutEvent,Arbitrum,4,4,4,8
2024-07-01 00:00:00.000,wormhole,WithdrawEvent,moonbeam,3,3,4,6
2024-01-22 00:00:00.000,mover,SwapOutEvent,BNB,4,4,4,8
2024-01-22 00:00:00.000,celer_cbridge,BurnEvent,BSC,4,4,4,8
2024-06-17 00:00:00.000,mover,SwapOutEvent,ZkSync,3,3,3,6
2024-04-22 00:00:00.000,celer_cbridge,MintEvent,Aptos,3,3,3,6
2024-04-22 00:00:00.000,wormhole,WithdrawEvent,moonbeam,3,3,3,6
2024-07-01 00:00:00.000,wormhole,WithdrawEvent,fantom,3,3,3,6
2024-04-01 00:00:00.000,mover,SwapOutEvent,Arbitrum,3,3,3,6
2024-01-15 00:00:00.000,celer_cbridge,BurnEvent,BSC,3,3,3,6
2024-01-29 00:00:00.000,mover,SwapOutEvent,Polygon,3,3,3,6
2024-04-01 00:00:00.000,celer_cbridge,BurnEvent,BSC,3,3,3,6
2024-02-05 00:00:00.000,mover,SwapOutEvent,Polygon,3,3,3,6
2024-06-24 00:00:00.000,layerzero,SendEvent,Base,3,3,3,6
2024-07-08 00:00:00.000,wormhole,WithdrawEvent,sei,2,2,3,4
2024-04-01 00:00:00.000,layerzero,SendEvent,Polygon zkEVM,3,3,3,6
2024-04-29 00:00:00.000,mover,SwapOutEvent,Arbitrum,2,2,3,4
2024-04-08 00:00:00.000,celer_cbridge,BurnEvent,Ethereum,3,3,3,6
2024-07-22 00:00:00.000,wormhole,WithdrawEvent,avalanche,2,2,3,4
2024-07-15 00:00:00.000,wormhole,WithdrawEvent,moonbeam,3,3,3,6
2024-06-24 00:00:00.000,celer_cbridge,MintEvent,Aptos,3,3,3,6
2024-04-08 00:00:00.000,wormhole,WithdrawEvent,acala,2,1,3,3
2024-04-29 00:00:00.000,mover,SwapOutEvent,ZkSync,3,3,3,6
2024-02-26 00:00:00.000,wormhole,WithdrawEvent,oasis,1,1,3,2
2024-05-20 00:00:00.000,mover,SwapOutEvent,Arbitrum,3,3,3,6
2024-09-02 00:00:00.000,wormhole,WithdrawEvent,polygon,3,3,3,6
2024-01-08 00:00:00.000,wormhole,WithdrawEvent,oasis,3,3,3,6
2024-01-15 00:00:00.000,mover,SwapOutEvent,ZkSync,3,3,3,6
2024-03-25 00:00:00.000,wormhole,WithdrawEvent,sei,1,3,3,4
2024-06-17 00:00:00.000,celer_cbridge,BurnEvent,Ethereum,3,3,3,6
2024-03-11 00:00:00.000,celer_cbridge,BurnEvent,BSC,3,3,3,6
2024-07-15 00:00:00.000,wormhole,WithdrawEvent,avalanche,2,2,3,4
2024-06-10 00:00:00.000,wormhole,WithdrawEvent,celo,3,3,3,6
2024-02-19 00:00:00.000,mover,SwapOutEvent,Polygon,3,3,3,6
2024-04-08 00:00:00.000,mover,SwapInEvent,aptos,3,3,3,6
2024-05-20 00:00:00.000,wormhole,WithdrawEvent,injective,3,3,3,6
2024-09-02 00:00:00.000,wormhole,WithdrawEvent,moonbeam,1,1,3,2
2024-08-26 00:00:00.000,wormhole,WithdrawEvent,fantom,3,3,3,6
2024-05-13 00:00:00.000,mover,SwapInEvent,aptos,3,3,3,6
2024-02-12 00:00:00.000,wormhole,WithdrawEvent,injective,2,2,3,4
2024-08-26 00:00:00.000,wormhole,WithdrawEvent,bsc,3,3,3,6
2024-08-12 00:00:00.000,wormhole,WithdrawEvent,base,3,3,3,6
2024-01-08 00:00:00.000,wormhole,WithdrawEvent,terra2,2,2,3,4
2024-08-19 00:00:00.000,celer_cbridge,MintEvent,Aptos,1,1,3,2
2024-07-15 00:00:00.000,wormhole,WithdrawEvent,celo,2,2,3,4
2024-04-22 00:00:00.000,layerzero,SendEvent,Polygon zkEVM,3,3,3,6
2024-05-20 00:00:00.000,layerzero,SendEvent,Base,3,3,3,6
2024-01-08 00:00:00.000,mover,SwapOutEvent,ZkSync,3,3,3,6
2024-03-25 00:00:00.000,mover,SwapOutEvent,ZkSync,2,2,3,4
2024-02-12 00:00:00.000,mover,SwapOutEvent,Polygon,3,3,3,6
2024-09-02 00:00:00.000,mover,SwapOutEvent,Arbitrum,3,3,3,6
2024-04-22 00:00:00.000,mover,SwapOutEvent,Polygon,3,3,3,6
2024-07-22 00:00:00.000,wormhole,WithdrawEvent,moonbeam,2,2,2,4
2024-08-05 00:00:00.000,wormhole,WithdrawEvent,avalanche,2,2,2,4
2024-04-22 00:00:00.000,wormhole,WithdrawEvent,avalanche,2,2,2,4
2024-06-03 00:00:00.000,layerzero,SendEvent,CoreDAO,2,2,2,4
2024-07-08 00:00:00.000,wormhole,WithdrawEvent,avalanche,1,1,2,2
2024-02-05 00:00:00.000,mover,SwapOutEvent,Optimism,2,2,2,4
2024-06-24 00:00:00.000,wormhole,WithdrawEvent,fantom,2,2,2,4
2024-09-02 00:00:00.000,celer_cbridge,MintEvent,Aptos,1,1,2,2
2024-01-08 00:00:00.000,wormhole,WithdrawEvent,karura,2,2,2,4
2024-08-12 00:00:00.000,wormhole,WithdrawEvent,optimism,2,2,2,4
2024-02-12 00:00:00.000,layerzero,SendEvent,Polygon zkEVM,2,2,2,4
2024-04-29 00:00:00.000,mover,SwapOutEvent,Polygon,2,2,2,4
2024-06-17 00:00:00.000,layerzero,SendEvent,CoreDAO,2,2,2,4
2024-07-01 00:00:00.000,celer_cbridge,BurnEvent,BSC,1,1,2,2
2024-04-29 00:00:00.000,wormhole,WithdrawEvent,klaytn,2,2,2,4
2024-06-10 00:00:00.000,layerzero,SendEvent,CoreDAO,2,2,2,4
2024-02-05 00:00:00.000,celer_cbridge,BurnEvent,BSC,2,2,2,4
2024-01-15 00:00:00.000,layerzero,SendEvent,Polygon zkEVM,2,2,2,4
2024-06-03 00:00:00.000,wormhole,WithdrawEvent,oasis,2,2,2,4
2024-04-08 00:00:00.000,wormhole,WithdrawEvent,fantom,2,2,2,4
2024-03-11 00:00:00.000,celer_cbridge,BurnEvent,Ethereum,2,2,2,4
2024-01-29 00:00:00.000,celer_cbridge,BurnEvent,Ethereum,2,2,2,4
2024-04-29 00:00:00.000,celer_cbridge,MintEvent,Aptos,2,2,2,4
2024-01-29 00:00:00.000,celer_cbridge,BurnEvent,BSC,2,2,2,4
2024-07-22 00:00:00.000,celer_cbridge,BurnEvent,Ethereum,1,1,2,2
2024-07-08 00:00:00.000,wormhole,WithdrawEvent,injective,2,2,2,4
2024-01-29 00:00:00.000,mover,SwapOutEvent,Optimism,1,1,2,2
2024-09-09 00:00:00.000,mover,SwapOutEvent,Arbitrum,1,1,2,2
2024-05-06 00:00:00.000,mover,SwapOutEvent,Arbitrum,2,2,2,4
2024-07-29 00:00:00.000,mover,SwapOutEvent,Optimism,1,1,2,2
2024-06-10 00:00:00.000,wormhole,WithdrawEvent,avalanche,2,2,2,4
2024-07-29 00:00:00.000,wormhole,WithdrawEvent,avalanche,2,2,2,4
2024-04-08 00:00:00.000,mover,SwapOutEvent,ZkSync,2,2,2,4
2024-05-13 00:00:00.000,wormhole,WithdrawEvent,celo,1,1,2,2
2024-07-01 00:00:00.000,wormhole,WithdrawEvent,celo,2,2,2,4
2024-09-02 00:00:00.000,wormhole,WithdrawEvent,bsc,2,2,2,4
2024-02-26 00:00:00.000,mover,SwapOutEvent,ZkSync,2,2,2,4
2024-01-08 00:00:00.000,celer_cbridge,BurnEvent,BSC,2,2,2,4
2024-04-08 00:00:00.000,celer_cbridge,MintEvent,Aptos,2,2,2,4
2024-09-02 00:00:00.000,wormhole,WithdrawEvent,optimism,2,2,2,4
2024-03-04 00:00:00.000,wormhole,WithdrawEvent,injective,1,1,2,2
2024-04-08 00:00:00.000,wormhole,WithdrawEvent,algorand,1,1,2,2
2024-04-08 00:00:00.000,celer_cbridge,BurnEvent,BSC,2,2,2,4
2024-04-08 00:00:00.000,mover,SwapOutEvent,Arbitrum,2,2,2,4
2024-03-18 00:00:00.000,wormhole,WithdrawEvent,sei,2,2,2,4
2024-06-03 00:00:00.000,celer_cbridge,BurnEvent,BSC,2,2,2,4
2024-05-27 00:00:00.000,mover,SwapInEvent,aptos,2,2,2,4
2024-07-15 00:00:00.000,wormhole,WithdrawEvent,injective,2,2,2,4
2024-03-18 00:00:00.000,mover,SwapOutEvent,Optimism,2,2,2,4
2024-07-08 00:00:00.000,wormhole,WithdrawEvent,celo,2,2,2,4
2024-07-01 00:00:00.000,wormhole,WithdrawEvent,avalanche,2,2,2,4
2024-01-08 00:00:00.000,celer_cbridge,MintEvent,Aptos,2,2,2,4
2024-04-15 00:00:00.000,wormhole,WithdrawEvent,avalanche,2,2,2,4
2024-09-09 00:00:00.000,wormhole,WithdrawEvent,base,1,1,2,2
2024-01-15 00:00:00.000,celer_cbridge,BurnEvent,Ethereum,2,2,2,4
2024-07-01 00:00:00.000,layerzero,SendEvent,Base,2,2,2,4
2024-05-13 00:00:00.000,wormhole,WithdrawEvent,sei,1,1,2,2
2024-02-12 00:00:00.000,celer_cbridge,BurnEvent,BSC,2,2,2,4
2024-05-27 00:00:00.000,wormhole,WithdrawEvent,xlayer,1,1,2,2
2024-02-19 00:00:00.000,celer_cbridge,MintEvent,Aptos,2,2,2,4
2024-09-09 00:00:00.000,wormhole,WithdrawEvent,polygon,2,2,2,4
2024-02-12 00:00:00.000,celer_cbridge,MintEvent,Aptos,2,2,2,4
2024-05-20 00:00:00.000,mover,SwapInEvent,aptos,2,2,2,4
2024-02-05 00:00:00.000,wormhole,WithdrawEvent,acala,2,2,2,4
2024-06-03 00:00:00.000,layerzero,SendEvent,Base,2,2,2,4
2024-07-29 00:00:00.000,mover,SwapOutEvent,Arbitrum,2,2,2,4
2024-04-22 00:00:00.000,mover,SwapOutEvent,Arbitrum,2,2,2,4
2024-01-22 00:00:00.000,mover,SwapOutEvent,Polygon,2,2,2,4
2024-02-19 00:00:00.000,wormhole,WithdrawEvent,terra2,1,1,2,2
2024-02-19 00:00:00.000,mover,SwapOutEvent,Sui,1,1,2,2
2024-04-01 00:00:00.000,wormhole,WithdrawEvent,klaytn,2,2,2,4
2024-05-13 00:00:00.000,layerzero,SendEvent,CoreDAO,2,2,2,4
2024-05-20 00:00:00.000,celer_cbridge,BurnEvent,BSC,2,2,2,4
2024-04-01 00:00:00.000,wormhole,WithdrawEvent,moonbeam,2,2,2,4
2024-01-22 00:00:00.000,layerzero,SendEvent,Polygon zkEVM,2,2,2,4
2024-05-13 00:00:00.000,layerzero,SendEvent,Polygon zkEVM,1,1,1,2
2024-08-05 00:00:00.000,wormhole,WithdrawEvent,injective,1,1,1,2
2024-04-22 00:00:00.000,celer_cbridge,BurnEvent,Ethereum,1,1,1,2
2024-01-08 00:00:00.000,mover,SwapOutEvent,Arbitrum,1,1,1,2
2024-06-17 00:00:00.000,celer_cbridge,MintEvent,Aptos,1,1,1,2
2024-09-09 00:00:00.000,mover,SwapOutEvent,Optimism,1,1,1,2
2024-05-27 00:00:00.000,celer_cbridge,MintEvent,Aptos,1,1,1,2
2024-08-19 00:00:00.000,mover,SwapOutEvent,Arbitrum,1,1,1,2
2024-04-29 00:00:00.000,celer_cbridge,BurnEvent,BSC,1,1,1,2
2024-05-13 00:00:00.000,wormhole,WithdrawEvent,blast,1,1,1,2
2024-04-08 00:00:00.000,wormhole,WithdrawEvent,injective,1,1,1,2
2024-08-26 00:00:00.000,celer_cbridge,BurnEvent,BSC,1,1,1,2
2024-08-26 00:00:00.000,celer_cbridge,MintEvent,Aptos,1,1,1,2
2024-04-01 00:00:00.000,mover,SwapOutEvent,Polygon,1,1,1,2
2024-09-02 00:00:00.000,layerzero,SendEvent,Base,1,1,1,2
2024-03-18 00:00:00.000,wormhole,WithdrawEvent,klaytn,1,1,1,2
2024-03-11 00:00:00.000,mover,SwapOutEvent,Polygon,1,1,1,2
2024-03-25 00:00:00.000,layerzero,SendEvent,Polygon zkEVM,1,1,1,2
2024-05-06 00:00:00.000,wormhole,WithdrawEvent,sei,1,1,1,2
2024-01-15 00:00:00.000,wormhole,WithdrawEvent,near,1,1,1,2
2024-02-19 00:00:00.000,wormhole,WithdrawEvent,algorand,1,1,1,2
2024-07-08 00:00:00.000,mover,SwapOutEvent,Arbitrum,1,1,1,2
2024-02-26 00:00:00.000,mover,SwapOutEvent,Arbitrum,1,1,1,2
2024-05-13 00:00:00.000,wormhole,WithdrawEvent,scroll,1,1,1,2
2024-02-05 00:00:00.000,mover,SwapOutEvent,Arbitrum,1,1,1,2
2024-02-12 00:00:00.000,wormhole,WithdrawEvent,algorand,1,1,1,2
2024-05-27 00:00:00.000,wormhole,WithdrawEvent,celo,1,1,1,2
2024-09-02 00:00:00.000,mover,SwapOutEvent,Optimism,1,1,1,2
2024-03-04 00:00:00.000,wormhole,WithdrawEvent,terra2,1,1,1,2
2024-04-22 00:00:00.000,mover,SwapOutEvent,ZkSync,1,1,1,2
2024-08-19 00:00:00.000,wormhole,WithdrawEvent,celo,1,1,1,2
2024-09-09 00:00:00.000,wormhole,WithdrawEvent,moonbeam,1,1,1,2
2024-06-17 00:00:00.000,mover,SwapOutEvent,Sui,1,1,1,2
2024-07-01 00:00:00.000,layerzero,SendEvent,Polygon zkEVM,1,1,1,2
2024-04-22 00:00:00.000,celer_cbridge,BurnEvent,BSC,1,1,1,2
2024-06-10 00:00:00.000,wormhole,WithdrawEvent,scroll,1,1,1,2
2024-03-04 00:00:00.000,wormhole,WithdrawEvent,klaytn,1,1,1,2
2024-01-15 00:00:00.000,mover,SwapOutEvent,Polygon,1,1,1,2
2024-02-26 00:00:00.000,celer_cbridge,BurnEvent,BSC,1,1,1,2
2024-02-19 00:00:00.000,celer_cbridge,BurnEvent,Ethereum,1,1,1,2
2024-01-29 00:00:00.000,wormhole,WithdrawEvent,acala,1,1,1,2
2024-01-22 00:00:00.000,wormhole,WithdrawEvent,near,1,1,1,2
2024-04-15 00:00:00.000,celer_cbridge,BurnEvent,Ethereum,1,1,1,2
2024-06-03 00:00:00.000,mover,SwapOutEvent,Optimism,1,1,1,2
2024-04-01 00:00:00.000,celer_cbridge,BurnEvent,Ethereum,1,1,1,2
2024-01-22 00:00:00.000,wormhole,WithdrawEvent,oasis,1,1,1,2
2024-03-11 00:00:00.000,mover,SwapOutEvent,BNB,1,1,1,2
2024-09-02 00:00:00.000,wormhole,WithdrawEvent,fantom,1,1,1,2
2024-01-29 00:00:00.000,mover,SwapOutEvent,ZkSync,1,1,1,2
2024-07-15 00:00:00.000,layerzero,SendEvent,Base,1,1,1,2
2024-06-24 00:00:00.000,mover,SwapOutEvent,Sui,1,1,1,2
2024-02-05 00:00:00.000,celer_cbridge,BurnEvent,Ethereum,1,1,1,2
2024-07-08 00:00:00.000,wormhole,WithdrawEvent,moonbeam,1,1,1,2
2024-03-04 00:00:00.000,celer_cbridge,BurnEvent,BSC,1,1,1,2
2024-08-12 00:00:00.000,mover,SwapOutEvent,Sui,1,1,1,2
2024-07-22 00:00:00.000,mover,SwapOutEvent,Polygon,1,1,1,2
2024-02-12 00:00:00.000,mover,SwapOutEvent,Arbitrum,1,1,1,2
2024-09-02 00:00:00.000,wormhole,WithdrawEvent,avalanche,1,1,1,2
2024-07-22 00:00:00.000,wormhole,WithdrawEvent,scroll,1,1,1,2
2024-07-15 00:00:00.000,wormhole,WithdrawEvent,klaytn,1,1,1,2
2024-06-10 00:00:00.000,mover,SwapOutEvent,Arbitrum,1,1,1,2
2024-01-29 00:00:00.000,layerzero,SendEvent,Polygon zkEVM,1,1,1,2
2024-05-06 00:00:00.000,layerzero,SendEvent,Base,1,1,1,2
2024-08-26 00:00:00.000,wormhole,WithdrawEvent,avalanche,1,1,1,2
2024-07-08 00:00:00.000,wormhole,WithdrawEvent,fantom,1,1,1,2
2024-03-11 00:00:00.000,wormhole,WithdrawEvent,acala,1,1,1,2
2024-04-15 00:00:00.000,wormhole,WithdrawEvent,sei,1,1,1,2
2024-05-20 00:00:00.000,celer_cbridge,MintEvent,Aptos,1,1,1,2
2024-04-15 00:00:00.000,mover,SwapOutEvent,Polygon,1,1,1,2
2024-05-27 00:00:00.000,layerzero,SendEvent,Base,1,1,1,2
2024-02-19 00:00:00.000,wormhole,WithdrawEvent,injective,1,1,1,2
2024-03-18 00:00:00.000,mover,SwapOutEvent,Sui,1,1,1,2
2024-02-12 00:00:00.000,mover,SwapOutEvent,Sui,1,1,1,2
2024-03-11 00:00:00.000,layerzero,SendEvent,Polygon zkEVM,1,1,1,2
2024-05-13 00:00:00.000,layerzero,SendEvent,Base,1,1,1,2
2024-03-04 00:00:00.000,mover,SwapOutEvent,BNB,1,1,1,2
2024-02-26 00:00:00.000,celer_cbridge,MintEvent,Aptos,1,1,1,2
2024-06-03 00:00:00.000,layerzero,SendEvent,Polygon zkEVM,1,1,1,2
2024-04-15 00:00:00.000,mover,SwapOutEvent,Optimism,1,1,1,2
2024-07-29 00:00:00.000,wormhole,WithdrawEvent,scroll,1,1,1,2
2024-05-13 00:00:00.000,mover,SwapOutEvent,Optimism,1,1,1,2
2024-05-20 00:00:00.000,wormhole,WithdrawEvent,moonbeam,1,1,1,2
2024-08-05 00:00:00.000,layerzero,SendEvent,Base,1,1,1,2
2024-04-29 00:00:00.000,layerzero,SendEvent,Polygon zkEVM,1,1,1,2
2024-08-12 00:00:00.000,wormhole,WithdrawEvent,celo,1,1,1,2
2024-07-29 00:00:00.000,wormhole,WithdrawEvent,fantom,1,1,1,2
2024-08-05 00:00:00.000,wormhole,WithdrawEvent,moonbeam,1,1,1,2
2024-05-06 00:00:00.000,layerzero,SendEvent,Polygon zkEVM,1,1,1,2
2024-05-27 00:00:00.000,celer_cbridge,BurnEvent,BSC,1,1,1,2
2024-07-29 00:00:00.000,wormhole,WithdrawEvent,injective,1,1,1,2
2024-08-26 00:00:00.000,wormhole,WithdrawEvent,injective,1,1,1,2
2024-06-24 00:00:00.000,wormhole,WithdrawEvent,scroll,1,1,1,2
2024-03-25 00:00:00.000,celer_cbridge,BurnEvent,Ethereum,1,1,1,2
2024-08-19 00:00:00.000,wormhole,WithdrawEvent,scroll,1,1,1,2
2024-09-09 00:00:00.000,mover,SwapOutEvent,Sui,1,1,1,2
2024-05-20 00:00:00.000,wormhole,WithdrawEvent,fantom,1,1,1,2
2024-03-18 00:00:00.000,celer_cbridge,BurnEvent,Ethereum,1,1,1,2
2024-02-05 00:00:00.000,wormhole,WithdrawEvent,terra2,1,1,1,2
2024-02-19 00:00:00.000,wormhole,WithdrawEvent,oasis,1,1,1,2
2024-01-22 00:00:00.000,wormhole,WithdrawEvent,acala,1,1,1,2
2024-04-08 00:00:00.000,mover,SwapOutEvent,Polygon,1,1,1,2
2024-05-06 00:00:00.000,mover,SwapOutEvent,Optimism,1,1,1,2
2024-08-05 00:00:00.000,mover,SwapOutEvent,Sui,1,1,1,2
2024-03-04 00:00:00.000,celer_cbridge,MintEvent,Aptos,1,1,1,2
2024-07-15 00:00:00.000,wormhole,WithdrawEvent,scroll,1,1,1,2
2024-03-25 00:00:00.000,wormhole,WithdrawEvent,injective,1,1,1,2
2024-07-29 00:00:00.000,layerzero,SendEvent,Base,1,1,1,2
2024-07-01 00:00:00.000,wormhole,WithdrawEvent,sei,1,1,1,2
2024-02-19 00:00:00.000,wormhole,WithdrawEvent,acala,1,1,1,2
2024-01-15 00:00:00.000,mover,SwapOutEvent,Arbitrum,1,1,1,2
2024-02-05 00:00:00.000,layerzero,SendEvent,Polygon zkEVM,1,1,1,2
